GeoCodeID,Date,Positive,Negative,HospitalizedCurrently,hospitalizedcumulative,InICUCurrently,inicucumulative,onventilatorcurrently,onventilatorcumulative,Recovered,Death,DeathConfirmed,DeathProbable,PositiveIncrease,NegativeIncrease,TotalTests,NewTests,NewDeaths,NewHospitalizations
28,3/7/2020,0,0,0,0,0,0,0,0,0,0,0,0,0,0,0,0,0,0
28,3/8/2020,0,0,0,0,0,0,0,0,0,0,0,0,0,0,0,0,0,0
28,3/9/2020,0,0,0,0,0,0,0,0,0,0,0,0,0,0,0,0,0,0
28,3/10/2020,0,0,0,0,0,0,0,0,0,0,0,0,0,0,0,0,0,0
28,3/11/2020,0,20,0,0,0,0,0,0,0,0,0,0,0,20,20,20,0,0
28,3/12/2020,1,41,0,0,0,0,0,0,0,0,0,0,1,21,42,22,0,0
28,3/13/2020,4,41,0,0,0,0,0,0,0,0,0,0,3,0,45,3,0,0
28,3/14/2020,6,84,0,0,0,0,0,0,0,0,0,0,2,43,90,45,0,0
28,3/15/2020,10,84,0,0,0,0,0,0,0,0,0,0,4,0,94,4,0,0
28,3/16/2020,12,277,0,0,0,0,0,0,0,0,0,0,2,193,289,195,0,0
28,3/17/2020,21,368,0,0,0,0,0,0,0,0,0,0,9,91,389,100,0,0
28,3/18/2020,34,479,0,0,0,0,0,0,0,0,0,0,13,111,513,124,0,0
28,3/19/2020,50,552,0,0,0,0,0,0,0,0,0,0,16,73,602,89,0,0
28,3/20/2020,80,695,0,0,0,0,0,0,0,1,0,0,30,143,775,173,1,0
28,3/21/2020,140,695,0,0,0,0,0,0,0,1,0,0,60,0,835,60,0,0
28,3/22/2020,207,1114,0,33,0,0,0,0,0,1,0,0,67,419,1321,486,0,33
28,3/23/2020,249,1143,0,33,0,0,0,0,0,1,0,0,42,29,1392,71,0,0
28,3/24/2020,320,1552,0,86,0,0,0,0,0,1,0,0,71,409,1872,480,0,53
28,3/25/2020,377,1566,0,117,0,0,0,0,0,2,0,0,57,14,1943,71,1,31
28,3/26/2020,485,2291,0,150,0,0,0,0,0,6,0,0,108,725,2776,833,4,33
28,3/27/2020,579,2560,0,185,0,0,0,0,0,8,0,0,94,269,3139,363,2,35
28,3/28/2020,663,2560,0,219,0,0,0,0,0,13,0,0,84,0,3223,84,5,34
28,3/29/2020,758,2560,0,235,0,0,0,0,0,14,0,0,95,0,3318,95,1,16
28,3/30/2020,847,2989,0,195,0,0,0,0,0,16,0,0,89,429,3836,518,2,-40
28,3/31/2020,937,3537,0,211,0,0,0,0,0,20,0,0,90,548,4474,638,4,16
28,4/1/2020,1073,3712,0,332,0,0,0,0,0,22,0,0,136,175,4785,311,2,121
28,4/2/2020,1177,4753,0,360,0,0,0,0,0,26,0,0,104,1041,5930,1145,4,28
28,4/3/2020,1358,4753,0,420,0,0,0,0,0,29,0,0,181,0,6111,181,3,60
28,4/4/2020,1455,5133,0,436,0,0,0,0,0,35,0,0,97,380,6588,477,6,16
28,4/5/2020,1638,5580,0,475,0,0,0,0,0,43,0,0,183,447,7218,630,8,39
28,4/6/2020,1738,18632,0,475,0,0,0,0,0,51,0,0,100,13052,20370,13152,8,0
28,4/7/2020,1915,18632,0,377,0,0,0,0,0,59,0,0,177,0,20547,177,8,-98
28,4/8/2020,2003,18632,0,410,0,0,0,0,0,67,0,0,88,0,20635,88,8,33
28,4/9/2020,2260,18632,0,441,0,0,0,0,0,76,0,0,257,0,20892,257,9,31
28,4/10/2020,2469,18632,0,482,0,0,0,0,0,82,0,0,209,0,21101,209,6,41
28,4/11/2020,2642,18632,0,528,0,0,0,0,0,93,0,0,173,0,21274,173,11,46
28,4/12/2020,2781,18632,0,548,0,0,0,0,0,96,0,0,139,0,21413,139,3,20
28,4/13/2020,2942,28042,0,549,124,0,84,0,0,98,0,0,161,9410,30984,9571,2,1
28,4/14/2020,3087,34791,0,596,154,0,99,0,0,111,0,0,145,6749,37878,6894,13,47
28,4/15/2020,3360,34791,0,645,154,0,99,0,0,122,0,0,273,0,38151,273,11,49
28,4/16/2020,3624,34791,0,682,154,0,99,0,0,129,0,0,264,0,38415,264,7,37
28,4/17/2020,3793,34791,0,736,154,0,99,0,0,140,0,0,169,0,38584,169,11,54
28,4/18/2020,3974,34791,0,782,154,0,99,0,0,152,0,0,181,0,38765,181,12,46
28,4/19/2020,4274,34791,0,808,138,0,79,0,0,159,0,0,300,0,39065,300,7,26
28,4/20/2020,4512,46922,548,819,146,0,89,0,0,169,0,0,238,12131,51434,12369,10,11
28,4/21/2020,4716,47648,548,858,146,0,89,0,0,183,0,0,204,726,52364,930,14,39
28,4/22/2020,4894,48941,628,910,162,0,86,0,0,193,0,0,178,1293,53835,1471,10,52
28,4/23/2020,5153,50236,595,946,156,0,78,0,0,201,0,0,259,1295,55389,1554,8,36
28,4/24/2020,5434,50236,586,970,148,0,74,0,0,209,0,0,281,0,55670,281,8,24
28,4/25/2020,5718,53239,649,996,152,0,78,0,0,221,0,0,284,3003,58957,3287,12,26
28,4/26/2020,5911,54877,644,1001,146,0,67,0,0,227,0,0,193,1638,60788,1831,6,5
28,4/27/2020,6094,57368,590,1060,142,0,71,0,0,229,0,0,183,2491,63462,2674,2,59
28,4/28/2020,6342,58070,639,1088,162,0,77,0,0,239,0,0,248,702,64412,950,10,28
28,4/29/2020,6569,59525,677,1126,151,0,69,0,3413,250,0,0,227,1455,66094,1682,11,38
28,4/30/2020,6815,59525,639,1175,146,0,72,0,3413,261,0,0,246,0,66340,246,11,49
28,5/1/2020,7212,64336,651,1226,160,0,75,0,3413,281,0,0,397,4811,71548,5208,20,51
28,5/2/2020,7441,67034,632,1265,142,0,71,0,3413,291,0,0,229,2698,74475,2927,10,39
28,5/3/2020,7550,70043,667,1298,143,0,73,0,3413,303,0,0,109,3009,77593,3118,12,33
28,5/4/2020,7877,71800,646,1316,145,0,78,0,4421,310,0,0,327,1757,79677,2084,7,18
28,5/5/2020,8207,72101,645,1352,162,0,77,0,4421,342,0,0,330,301,80308,631,32,36
28,5/6/2020,8424,72101,618,1392,144,0,79,0,4421,374,0,0,217,0,80525,217,32,40
28,5/7/2020,8686,72101,650,1442,139,0,71,0,4421,396,0,0,262,0,80787,262,22,50
28,5/8/2020,9090,72101,632,1478,123,0,58,0,4421,409,0,0,404,0,81191,404,13,36
28,5/9/2020,9378,72101,607,1512,133,0,76,0,4421,421,0,0,288,0,81479,288,12,34
28,5/10/2020,9501,72101,645,1531,141,0,78,0,4421,430,0,0,123,0,81602,123,9,19
28,5/11/2020,9674,86211,507,1546,132,0,68,0,6268,435,0,0,173,14110,95885,14283,5,15
28,5/12/2020,9908,87784,604,1582,146,0,75,0,6268,457,0,0,234,1573,97692,1807,22,36
28,5/13/2020,10090,89958,604,1616,150,0,79,0,6268,465,0,0,182,2174,100048,2356,8,34
28,5/14/2020,10483,94843,589,1667,131,0,72,0,6268,480,0,0,393,4885,105326,5278,15,51
28,5/15/2020,10801,96022,573,1712,172,0,81,0,6268,493,0,0,318,1179,106823,1497,13,45
28,5/16/2020,11123,97353,641,1748,170,0,81,0,6268,510,0,0,322,1331,108476,1653,17,36
28,5/17/2020,11296,101830,608,1773,158,0,81,0,6268,521,0,0,173,4477,113126,4650,11,25
28,5/18/2020,11432,104335,559,1805,141,0,75,0,7681,528,0,0,136,2505,115767,2641,7,32
28,5/19/2020,11704,106056,611,1840,153,0,87,0,7681,554,0,0,272,1721,117760,1993,26,35
28,5/20/2020,11967,108713,644,1901,157,0,89,0,7681,570,0,0,263,2657,120680,2920,16,61
28,5/21/2020,12222,113748,638,1932,158,0,92,0,7681,580,0,0,255,5035,125970,5290,10,31
28,5/22/2020,12624,125349,557,1966,159,0,85,0,7681,596,0,0,402,11601,137973,12003,16,34
28,5/23/2020,13005,121215,590,1996,154,0,93,0,7681,616,0,0,381,-4134,134220,-3753,20,30
28,5/24/2020,13252,124650,512,2023,150,0,73,0,7681,625,0,0,247,3435,137902,3682,9,27
28,5/25/2020,13458,130459,566,2046,152,0,94,0,9401,635,0,0,206,5809,143917,6015,10,23
28,5/26/2020,13731,134088,561,2070,134,0,81,0,9401,652,0,0,273,3629,147819,3902,17,24
28,5/27/2020,14044,134088,547,2106,127,0,73,0,9401,670,0,0,313,0,148132,313,18,36
28,5/28/2020,14372,142125,594,2147,148,0,78,0,9401,693,0,0,328,8037,156497,8365,23,41
28,5/29/2020,14790,151518,584,2208,121,0,77,0,9401,710,0,0,418,9393,166308,9811,17,61
28,5/30/2020,15229,150703,593,2240,145,0,92,0,9401,723,0,0,439,-815,165932,-376,13,32
28,5/31/2020,15501,156336,570,2272,113,0,108,0,9401,734,0,0,272,5633,171837,5905,11,32
28,6/1/2020,15752,160502,584,2296,146,0,97,0,11203,739,0,0,251,4166,176254,4417,5,24
28,6/2/2020,16020,163478,584,2296,146,0,97,0,11203,767,752,15,268,2976,179498,3244,28,0
28,6/3/2020,16322,168425,602,2340,141,0,96,0,11203,782,767,15,302,4947,184747,5249,15,44
28,6/4/2020,16560,168425,633,2340,145,0,97,0,11203,794,778,16,238,0,184985,238,12,0
28,6/5/2020,16759,176354,604,2475,149,0,84,0,11203,803,787,16,199,7929,193113,8128,9,135
28,6/6/2020,16769,176354,604,2475,149,0,84,0,11203,803,787,16,10,0,193123,10,0,0
28,6/7/2020,17270,185979,585,2522,133,0,69,0,11203,817,801,16,501,9625,203249,10126,14,47
28,6/8/2020,17768,190444,598,2535,142,0,83,0,13356,837,821,16,498,4465,208212,4963,20,13
28,6/9/2020,17768,190444,598,2535,142,0,83,0,13356,837,821,16,0,0,208212,0,0,0
28,6/10/2020,18483,195402,655,2614,160,0,99,0,13356,868,851,17,715,4958,213885,5673,31,79
28,6/11/2020,18483,195402,655,2614,160,0,99,0,13356,868,851,17,0,0,213885,0,0,0
28,6/12/2020,19091,195402,710,2643,172,0,94,0,13356,881,856,16,608,0,214493,608,13,29
28,6/13/2020,19348,194537,684,2644,160,0,103,0,13356,889,873,16,257,-865,213885,-608,8,1
28,6/14/2020,19516,194537,667,2665,151,0,99,0,13356,891,873,16,168,0,214053,168,2,21
28,6/15/2020,19799,210704,661,2680,163,0,100,0,15323,895,879,16,283,16167,230503,16450,4,15
28,6/16/2020,20152,220651,668,2728,160,0,98,0,15323,915,899,16,353,9947,240803,10300,20,48
28,6/17/2020,20641,223748,668,2767,161,0,100,0,15323,938,922,16,489,3097,244389,3586,23,39
28,6/18/2020,20641,218074,668,2767,161,0,100,0,15323,938,922,16,0,-5674,238715,-5674,0,0
28,6/19/2020,20641,218074,661,2767,159,0,108,0,15323,938,922,16,0,0,238715,0,0,0
28,6/20/2020,20641,218074,465,2767,159,0,108,0,15323,938,922,16,0,0,238715,0,0,0
28,6/21/2020,20641,218074,689,2767,156,0,98,0,15323,938,922,16,0,0,238715,0,0,0
28,6/22/2020,22287,230962,710,2881,148,0,95,0,17242,978,961,17,1646,12888,253249,14534,40,114
28,6/23/2020,22898,230962,664,2915,151,0,88,0,17242,989,972,17,611,0,253860,611,11,34
28,6/24/2020,23424,238237,767,2946,157,0,91,0,17242,1011,994,17,526,7275,261661,7801,22,31
28,6/25/2020,24516,241481,755,2998,157,0,94,0,17242,1016,999,17,1092,3244,265997,4336,5,52
28,6/26/2020,25066,246828,769,3044,153,0,90,0,17242,1022,1005,17,550,5347,271894,5897,6,46
28,6/27/2020,25531,251790,731,3078,169,0,90,0,17242,1035,1018,17,465,4962,277321,5427,13,34
28,6/28/2020,25892,254296,676,3102,149,0,88,0,17242,1039,1022,17,361,2506,280188,2867,4,24
28,6/29/2020,26567,256955,719,3115,158,0,93,0,19388,1059,1042,17,675,2659,283522,3334,20,13
28,6/30/2020,27247,260299,779,3156,167,0,91,0,19388,1073,1056,17,680,3344,287546,4024,14,41
28,7/1/2020,27900,265852,786,3177,160,0,85,0,19388,1082,1064,18,653,5553,293752,6206,9,21
28,7/2/2020,28770,270269,863,3208,167,0,94,0,19388,1092,1074,18,870,4417,299039,5287,10,31
28,7/3/2020,28770,270269,863,3208,167,0,94,0,19388,1092,1074,18,0,0,299039,0,0,0
28,7/4/2020,30674,279241,872,3268,175,0,88,0,19388,1107,1089,18,1904,8972,309915,10876,15,60
28,7/5/2020,30900,279241,872,3268,175,0,88,0,19388,1111,1093,18,226,0,310141,226,4,0
28,7/6/2020,31257,283431,825,3280,165,0,98,0,22167,1114,1096,18,357,4190,314688,4547,3,12
28,7/7/2020,32214,283431,885,3315,173,0,95,0,22167,1158,1139,19,957,0,315645,957,44,35
28,7/8/2020,32888,281839,883,3365,190,0,101,0,22167,1188,1168,20,674,-1592,314727,-918,30,50
28,7/9/2020,33591,291213,941,3414,187,0,104,0,22167,1204,1184,20,703,9374,324804,10077,16,49
28,7/10/2020,34622,295690,981,3455,205,0,103,0,22167,1215,1195,20,1031,4477,330312,5508,11,41
28,7/11/2020,35419,298924,963,3495,202,0,107,0,22167,1230,1208,22,797,3234,334343,4031,15,40
28,7/12/2020,36287,298924,963,3495,202,0,107,0,22167,1249,1227,22,868,0,335211,868,19,0
28,7/13/2020,36680,306735,1020,3530,208,0,110,0,25932,1250,1228,22,393,7811,343415,8204,1,35
28,7/14/2020,37542,312671,1059,3585,227,0,126,0,25932,1272,1249,23,862,5936,350213,6798,22,55
28,7/15/2020,38567,318290,1099,3629,240,0,132,0,25932,1290,1266,24,1025,5619,356857,6644,18,44
28,7/16/2020,39797,324103,1117,3675,247,0,125,0,25932,1308,1283,25,1230,5813,363900,7043,18,46
28,7/17/2020,40829,330635,1076,3712,253,0,129,0,25932,1332,1303,29,1032,6532,371464,7564,24,37
29,3/7/2020,0,0,0,0,0,0,0,0,0,0,0,0,0,0,0,0,0,0
29,3/8/2020,1,0,0,0,0,0,0,0,0,0,0,0,1,0,1,1,0,0
29,3/9/2020,1,0,0,0,0,0,0,0,0,0,0,0,0,0,1,0,0,0
29,3/10/2020,1,0,0,0,0,0,0,0,0,0,0,0,0,0,1,0,0,0
29,3/11/2020,1,0,0,0,0,0,0,0,0,0,0,0,0,0,1,0,0,0
29,3/12/2020,1,64,0,0,0,0,0,0,0,0,0,0,0,64,65,64,0,0
29,3/13/2020,2,71,0,0,0,0,0,0,0,0,0,0,1,7,73,8,0,0
29,3/14/2020,4,90,0,0,0,0,0,0,0,0,0,0,2,19,94,21,0,0
29,3/15/2020,5,122,0,0,0,0,0,0,0,0,0,0,1,32,127,33,0,0
29,3/16/2020,6,164,0,0,0,0,0,0,0,0,0,0,1,42,170,43,0,0
29,3/17/2020,8,207,0,0,0,0,0,0,0,0,0,0,2,43,215,45,0,0
29,3/18/2020,13,253,0,0,0,0,0,0,0,0,0,0,5,46,266,51,0,0
29,3/19/2020,24,308,0,0,0,0,0,0,0,1,0,0,11,55,332,66,1,0
29,3/20/2020,47,369,0,0,0,0,0,0,0,1,0,0,23,61,416,84,0,0
29,3/21/2020,73,369,0,0,0,0,0,0,0,3,0,0,26,0,442,26,2,0
29,3/22/2020,90,369,0,0,0,0,0,0,0,3,0,0,17,0,459,17,0,0
29,3/23/2020,183,369,0,0,0,0,0,0,0,3,0,0,93,0,552,93,0,0
29,3/24/2020,183,369,0,0,0,0,0,0,0,3,0,0,0,0,552,0,0,0
29,3/25/2020,356,369,0,0,0,0,0,0,0,8,0,0,173,0,725,173,5,0
29,3/26/2020,502,369,0,0,0,0,0,0,0,8,0,0,146,0,871,146,0,0
29,3/27/2020,669,369,0,0,0,0,0,0,0,8,0,0,167,0,1038,167,0,0
29,3/28/2020,838,10082,0,0,0,0,0,0,0,10,0,0,169,9713,10920,9882,2,0
29,3/29/2020,838,11547,0,0,0,0,0,0,0,10,0,0,0,1465,12385,1465,0,0
29,3/30/2020,1031,13204,0,0,0,0,0,0,0,13,0,0,193,1657,14235,1850,3,0
29,3/31/2020,1327,14614,0,0,0,0,0,0,0,14,0,0,296,1410,15941,1706,1,0
29,4/1/2020,1581,15846,0,0,0,0,0,0,0,18,0,0,254,1232,17427,1486,4,0
29,4/2/2020,1834,17849,0,0,0,0,0,0,0,19,0,0,253,2003,19683,2256,1,0
29,4/3/2020,2113,19357,0,0,0,0,0,0,0,19,0,0,279,1508,21470,1787,0,0
29,4/4/2020,2291,22614,413,0,0,0,0,0,0,24,0,0,178,3257,24905,3435,5,0
29,4/5/2020,2367,24882,424,0,0,0,0,0,0,34,0,0,76,2268,27249,2344,10,0
29,4/6/2020,2722,27113,439,0,0,0,0,0,0,39,0,0,355,2231,29835,2586,5,0
29,4/7/2020,3037,28932,508,0,0,0,0,0,0,53,0,0,315,1819,31969,2134,14,0
29,4/8/2020,3327,30783,519,0,0,0,0,0,0,58,0,0,290,1851,34110,2141,5,0
29,4/9/2020,3539,34955,568,0,0,0,0,0,0,77,0,0,212,4172,38494,4384,19,0
29,4/10/2020,3799,36941,568,0,0,0,0,0,0,96,0,0,260,1986,40740,2246,19,0
29,4/11/2020,4024,39148,506,0,0,0,0,0,0,109,0,0,225,2207,43172,2432,13,0
29,4/12/2020,4160,41040,988,0,0,0,0,0,0,110,0,0,136,1892,45200,2028,1,0
29,4/13/2020,4388,41040,988,0,0,0,0,0,0,114,0,0,228,0,45428,228,4,0
29,4/14/2020,4686,43292,1041,0,0,0,0,0,0,133,0,0,298,2252,47978,2550,19,0
29,4/15/2020,4895,44117,1024,0,0,0,0,0,0,147,0,0,209,825,49012,1034,14,0
29,4/16/2020,5111,45537,1043,0,0,0,0,0,0,152,0,0,216,1420,50648,1636,5,0
29,4/17/2020,5283,46434,1043,0,0,0,0,0,0,165,0,0,172,897,51717,1069,13,0
29,4/18/2020,5517,48242,875,0,0,0,0,0,0,175,0,0,234,1808,53759,2042,10,0
29,4/19/2020,5667,48242,875,0,0,0,0,0,0,176,0,0,150,0,53909,150,1,0
29,4/20/2020,5807,50206,873,0,0,0,0,0,0,177,0,0,140,1964,56013,2104,1,0
29,4/21/2020,5941,51179,1001,0,0,0,0,0,0,189,0,0,134,973,57120,1107,12,0
29,4/22/2020,6137,52019,1001,0,0,0,0,0,0,208,0,0,196,840,58156,1036,19,0
29,4/23/2020,6321,53129,884,0,0,0,0,0,0,218,0,0,184,1110,59450,1294,10,0
29,4/24/2020,6625,58582,877,0,0,0,0,0,0,262,0,0,304,5453,65207,5757,44,0
29,4/25/2020,6826,60392,850,0,0,0,142,0,0,273,0,0,201,1810,67218,2011,11,0
29,4/26/2020,6997,62751,679,0,0,0,109,0,0,274,0,0,171,2359,69748,2530,1,0
29,4/27/2020,7171,63935,679,0,0,0,109,0,0,288,0,0,174,1184,71106,1358,14,0
29,4/28/2020,7303,66200,655,0,0,0,105,0,0,314,0,0,132,2265,73503,2397,26,0
29,4/29/2020,7425,69734,891,0,0,0,125,0,0,318,0,0,122,3534,77159,3656,4,0
29,4/30/2020,7562,73125,853,0,0,0,141,0,0,329,0,0,137,3391,80687,3528,11,0
29,5/1/2020,7835,74590,883,0,0,0,137,0,0,337,0,0,273,1465,82425,1738,8,0
29,5/2/2020,8154,74590,896,0,0,0,141,0,0,351,0,0,319,0,82744,319,14,0
29,5/3/2020,8386,74590,896,0,0,0,141,0,0,352,0,0,232,0,82976,232,1,0
29,5/4/2020,8754,82697,858,0,0,0,135,0,0,358,0,0,368,8107,91451,8475,6,0
29,5/5/2020,8916,86150,893,0,0,0,139,0,0,377,0,0,162,3453,95066,3615,19,0
29,5/6/2020,9102,91645,953,0,0,0,134,0,0,396,0,0,186,5495,100747,5681,19,0
29,5/7/2020,9341,94281,917,0,0,0,141,0,0,418,0,0,239,2636,103622,2875,22,0
29,5/8/2020,9489,99232,832,0,0,0,143,0,0,449,0,0,148,4951,108721,5099,31,0
29,5/9/2020,9666,99232,855,0,0,0,144,0,0,472,0,0,177,0,108898,177,23,0
29,5/10/2020,9844,105702,824,0,0,0,137,0,0,482,0,0,178,6470,115546,6648,10,0
29,5/11/2020,9918,105702,824,0,0,0,137,0,0,488,0,0,74,0,115620,74,6,0
29,5/12/2020,10006,111290,787,0,0,0,140,0,0,524,0,0,88,5588,121296,5676,36,0
29,5/13/2020,10142,114000,771,0,0,0,129,0,0,542,0,0,136,2710,124142,2846,18,0
29,5/14/2020,10317,116793,796,0,0,0,115,0,0,562,0,0,175,2793,127110,2968,20,0
29,5/15/2020,10456,124002,812,0,0,0,120,0,0,576,0,0,139,7209,134458,7348,14,0
29,5/16/2020,10675,128665,775,0,0,0,116,0,0,589,0,0,219,4663,139340,4882,13,0
29,5/17/2020,10789,135466,775,0,0,0,116,0,0,594,0,0,114,6801,146255,6915,5,0
29,5/18/2020,10945,140393,570,0,0,0,91,0,0,605,0,0,156,4927,151338,5083,11,0
29,5/19/2020,11080,143030,721,0,0,0,103,0,0,616,0,0,135,2637,154110,2772,11,0
29,5/20/2020,11232,150752,546,0,0,0,103,0,0,631,0,0,152,7722,161984,7874,15,0
29,5/21/2020,11340,150752,697,0,0,0,99,0,0,661,0,0,108,0,162092,108,30,0
29,5/22/2020,11558,161388,711,0,0,0,93,0,0,671,0,0,218,10636,172946,10854,10,0
29,5/23/2020,11752,136552,742,0,0,0,94,0,0,676,0,0,194,-24836,148304,-24642,5,0
29,5/24/2020,11988,139631,742,0,0,0,94,0,0,681,0,0,236,3079,151619,3315,5,0
29,5/25/2020,12167,145218,729,0,0,0,93,0,0,685,0,0,179,5587,157385,5766,4,0
29,5/26/2020,12291,148007,500,0,0,0,82,0,0,686,0,0,124,2789,160298,2913,1,0
29,5/27/2020,12492,153029,644,0,0,0,84,0,0,696,0,0,201,5022,165521,5223,10,0
29,5/28/2020,12673,158394,648,0,0,0,88,0,0,707,0,0,181,5365,171067,5546,11,0
29,5/29/2020,12795,165055,650,0,0,0,85,0,0,738,0,0,122,6661,177850,6783,31,0
29,5/30/2020,12962,172468,679,0,0,0,85,0,0,771,0,0,167,7413,185430,7580,33,0
29,5/31/2020,13147,180414,718,0,0,0,83,0,0,772,0,0,185,7946,193561,8131,1,0
29,6/1/2020,13327,186381,693,0,0,0,78,0,0,773,0,0,180,5967,199708,6147,1,0
29,6/2/2020,13575,191855,693,0,0,0,81,0,0,783,0,0,248,5474,205430,5722,10,0
29,6/3/2020,13767,197586,571,0,0,0,70,0,0,786,0,0,192,5731,211353,5923,3,0
29,6/4/2020,14057,204604,599,0,0,0,82,0,0,786,0,0,290,7018,218661,7308,0,0
29,6/5/2020,14253,210289,666,0,0,0,79,0,0,799,0,0,196,5685,224542,5881,13,0
29,6/6/2020,14442,215623,666,0,0,0,79,0,0,809,0,0,189,5334,230065,5523,10,0
29,6/7/2020,14553,222305,657,0,0,0,84,0,0,809,0,0,111,6682,236858,6793,0,0
29,6/8/2020,14734,226727,611,0,0,0,76,0,0,819,0,0,181,4422,241461,4603,10,0
29,6/9/2020,14913,230782,533,0,0,0,59,0,0,840,0,0,179,4055,245695,4234,21,0
29,6/10/2020,15187,236442,533,0,0,0,59,0,0,848,0,0,274,5660,251629,5934,8,0
29,6/11/2020,15390,243650,537,0,0,0,59,0,0,860,0,0,203,7208,259040,7411,12,0
29,6/12/2020,15585,249550,593,0,0,0,69,0,0,872,0,0,195,5900,265135,6095,12,0
29,6/13/2020,15810,253986,595,0,0,0,69,0,0,879,0,0,225,4436,269796,4661,7,0
29,6/14/2020,15810,259679,647,0,0,0,65,0,0,879,0,0,0,5693,275489,5693,0,0
29,6/15/2020,16189,263752,612,0,0,0,64,0,0,880,0,0,379,4073,279941,4452,1,0
29,6/16/2020,16414,268377,524,0,0,0,66,0,0,882,0,0,225,4625,284791,4850,2,0
29,6/17/2020,16625,268377,533,0,0,0,66,0,0,909,0,0,211,0,285002,211,27,0
29,6/18/2020,16908,280434,533,0,0,0,64,0,0,946,0,0,283,12057,297342,12340,37,0
29,6/19/2020,17201,289083,594,0,0,0,70,0,0,948,0,0,293,8649,306284,8942,2,0
29,6/20/2020,17590,293525,415,0,0,0,66,0,0,955,0,0,389,4442,311115,4831,7,0
29,6/21/2020,18003,297154,415,0,0,0,66,0,0,956,0,0,413,3629,315157,4042,1,0
29,6/22/2020,18143,299231,415,0,0,0,66,0,0,961,0,0,140,2077,317374,2217,5,0
29,6/23/2020,18143,299231,595,0,0,0,66,0,0,961,0,0,0,0,317374,0,0,0
29,6/24/2020,18868,308156,546,0,0,0,66,0,0,975,0,0,725,8925,327024,9650,14,0
29,6/25/2020,19421,322227,546,0,0,0,66,0,0,982,0,0,553,14071,341648,14624,7,0
29,6/26/2020,19914,328704,600,0,0,0,66,0,0,990,0,0,493,6477,348618,6970,8,0
29,6/27/2020,20261,335029,680,0,0,0,66,0,0,996,0,0,347,6325,355290,6672,6,0
29,6/28/2020,20575,340598,412,0,0,0,0,0,0,997,0,0,314,5569,361173,5883,1,0
29,6/29/2020,21043,346363,599,0,0,0,0,0,0,998,0,0,468,5765,367406,6233,1,0
29,6/30/2020,21551,351456,599,0,0,0,66,0,0,1015,0,0,508,5093,373007,5601,17,0
29,7/1/2020,21927,367813,592,0,0,0,75,0,0,1017,0,0,376,16357,389740,16733,2,0
29,7/2/2020,22283,375035,716,0,0,0,77,0,0,1022,0,0,356,7222,397318,7578,5,0
29,7/3/2020,22830,382129,716,0,0,0,78,0,0,1026,0,0,547,7094,404959,7641,4,0
29,7/4/2020,23215,389046,740,0,0,0,73,0,0,1027,0,0,385,6917,412261,7302,1,0
29,7/5/2020,23436,396073,739,0,0,0,72,0,0,1028,0,0,221,7027,419509,7248,1,0
29,7/6/2020,23856,402889,740,0,0,0,73,0,0,1028,0,0,420,6816,426745,7236,0,0
29,7/7/2020,24629,410719,676,0,0,0,67,0,0,1042,0,0,773,7830,435348,8603,14,0
29,7/8/2020,25204,417136,694,0,0,0,74,0,0,1046,0,0,575,6417,442340,6992,4,0
29,7/9/2020,25999,428826,811,0,0,0,75,0,0,1051,0,0,795,11690,454825,12485,5,0
29,7/10/2020,25999,428826,886,0,0,0,79,0,0,1051,0,0,0,0,454825,0,0,0
29,7/11/2020,27133,447417,883,0,0,0,72,0,0,1069,0,0,1134,18591,474550,19725,18,0
29,7/12/2020,27443,458065,883,0,0,0,80,0,0,1069,0,0,310,10648,485508,10958,0,0
29,7/13/2020,27890,467887,932,0,0,0,89,0,0,1083,0,0,447,9822,495777,10269,14,0
29,7/14/2020,28826,476277,811,0,0,0,74,0,0,1093,0,0,936,8390,505103,9326,10,0
29,7/15/2020,29714,488233,875,0,0,0,86,0,0,1102,0,0,888,11956,517947,12844,9,0
29,7/16/2020,30422,498879,875,0,0,0,86,0,0,1113,0,0,708,10646,529301,11354,11,0
29,7/17/2020,31288,506608,875,0,0,0,86,0,0,1121,0,0,866,7729,537896,8595,8,0
30,3/7/2020,0,11,0,0,0,0,0,0,0,0,0,0,0,0,11,0,0,0
30,3/8/2020,0,11,0,0,0,0,0,0,0,0,0,0,0,0,11,0,0,0
30,3/9/2020,0,11,0,0,0,0,0,0,0,0,0,0,0,0,11,0,0,0
30,3/10/2020,0,15,0,0,0,0,0,0,0,0,0,0,0,4,15,4,0,0
30,3/11/2020,0,21,0,0,0,0,0,0,0,0,0,0,0,6,21,6,0,0
30,3/12/2020,1,34,0,0,0,0,0,0,0,0,0,0,1,13,35,14,0,0
30,3/13/2020,1,55,0,0,0,0,0,0,0,0,0,0,0,21,56,21,0,0
30,3/14/2020,5,103,0,0,0,0,0,0,0,0,0,0,4,48,108,52,0,0
30,3/15/2020,7,103,0,0,0,0,0,0,0,0,0,0,2,0,110,2,0,0
30,3/16/2020,7,198,0,0,0,0,0,0,0,0,0,0,0,95,205,95,0,0
30,3/17/2020,8,303,0,0,0,0,0,0,0,0,0,0,1,105,311,106,0,0
30,3/18/2020,10,499,0,0,0,0,0,0,0,0,0,0,2,196,509,198,0,0
30,3/19/2020,12,761,0,0,0,0,0,0,0,0,0,0,2,262,773,264,0,0
30,3/20/2020,16,931,0,0,0,0,0,0,0,0,0,0,4,170,947,174,0,0
30,3/21/2020,20,1146,0,0,0,0,0,0,0,0,0,0,4,215,1166,219,0,0
30,3/22/2020,31,1146,0,0,0,0,0,0,0,0,0,0,11,0,1177,11,0,0
30,3/23/2020,34,1146,0,0,0,0,0,0,0,0,0,0,3,0,1180,3,0,0
30,3/24/2020,46,1643,0,0,0,0,0,0,0,0,0,0,12,497,1689,509,0,0
30,3/25/2020,53,1948,0,0,0,0,0,0,0,0,0,0,7,305,2001,312,0,0
30,3/26/2020,71,2128,0,1,0,0,0,0,0,0,0,0,18,180,2199,198,0,1
30,3/27/2020,108,2590,0,7,0,0,0,0,0,0,0,0,37,462,2698,499,0,6
30,3/28/2020,129,3256,0,7,0,0,0,0,0,1,0,0,21,666,3385,687,1,0
30,3/29/2020,154,4143,0,8,0,0,0,0,0,1,0,0,25,887,4297,912,0,1
30,3/30/2020,171,4143,0,10,0,0,0,0,0,4,0,0,17,0,4314,17,3,2
30,3/31/2020,184,4234,0,14,0,0,0,0,0,4,0,0,13,91,4418,104,0,4
30,4/1/2020,208,4710,0,17,0,0,0,0,0,5,0,0,24,476,4918,500,1,3
30,4/2/2020,227,5093,0,20,0,0,0,0,0,5,0,0,19,383,5320,402,0,3
30,4/3/2020,243,5333,0,24,0,0,0,0,0,5,0,0,16,240,5576,256,0,4
30,4/4/2020,265,5912,0,24,0,0,0,0,0,5,0,0,22,579,6177,601,0,0
30,4/5/2020,286,6317,0,24,0,0,0,0,0,6,0,0,21,405,6603,426,1,0
30,4/6/2020,299,6491,0,24,0,0,0,0,0,6,0,0,13,174,6790,187,0,0
30,4/7/2020,319,6666,0,28,0,0,0,0,0,6,0,0,20,175,6985,195,0,4
30,4/8/2020,332,7066,0,31,0,0,0,0,135,6,0,0,13,400,7398,413,0,3
30,4/9/2020,354,7506,13,36,0,0,0,0,157,6,0,0,22,440,7860,462,0,5
30,4/10/2020,365,7932,29,41,0,0,0,0,165,6,0,0,11,426,8297,437,0,5
30,4/11/2020,377,8204,21,46,0,0,0,0,169,6,0,0,12,272,8581,284,0,5
30,4/12/2020,387,8526,22,47,0,0,0,0,169,6,0,0,10,322,8913,332,0,1
30,4/13/2020,394,8704,21,47,0,0,0,0,171,7,0,0,7,178,9098,185,1,0
30,4/14/2020,399,8835,24,50,0,0,0,0,197,7,0,0,5,131,9234,136,0,3
30,4/15/2020,404,9179,21,51,0,0,0,0,209,7,0,0,5,344,9583,349,0,1
30,4/16/2020,415,9521,21,52,0,0,0,0,218,7,0,0,11,342,9936,353,0,1
30,4/17/2020,422,9822,21,54,0,0,0,0,233,8,0,0,7,301,10244,308,1,2
30,4/18/2020,426,10143,17,55,0,0,0,0,234,10,0,0,4,321,10569,325,2,1
30,4/19/2020,433,10465,18,55,0,0,0,0,243,10,0,0,7,322,10898,329,0,0
30,4/20/2020,433,10618,19,57,0,0,0,0,243,10,0,0,0,153,11051,153,0,2
30,4/21/2020,437,10804,14,59,0,0,0,0,273,12,0,0,4,186,11241,190,2,2
30,4/22/2020,439,11144,13,59,0,0,0,0,296,14,0,0,2,340,11583,342,2,0
30,4/23/2020,442,11433,13,59,0,0,0,0,306,14,0,0,3,289,11875,292,0,0
30,4/24/2020,444,11683,12,59,0,0,0,0,325,14,0,0,2,250,12127,252,0,0
30,4/25/2020,445,12052,11,61,0,0,0,0,339,14,0,0,1,369,12497,370,0,2
30,4/26/2020,448,12414,11,61,0,0,0,0,339,14,0,0,3,362,12862,365,0,0
30,4/27/2020,449,12584,11,61,0,0,0,0,352,14,0,0,1,170,13033,171,0,0
30,4/28/2020,451,12740,10,61,0,0,0,0,356,15,0,0,2,156,13191,158,1,0
30,4/29/2020,451,13077,5,61,0,0,0,0,382,16,0,0,0,337,13528,337,1,0
30,4/30/2020,453,13461,5,61,0,0,0,0,392,16,0,0,2,384,13914,386,0,0
30,5/1/2020,453,13750,5,61,0,0,0,0,397,16,0,0,0,289,14203,289,0,0
30,5/2/2020,455,14180,5,61,0,0,0,0,404,16,0,0,2,430,14635,432,0,0
30,5/3/2020,455,14552,5,61,0,0,0,0,404,16,0,0,0,372,15007,372,0,0
30,5/4/2020,457,14631,6,62,0,0,0,0,404,16,0,0,2,79,15088,81,0,1
30,5/5/2020,456,14816,6,62,0,0,0,0,410,16,0,0,-1,185,15272,184,0,0
30,5/6/2020,456,19248,6,62,0,0,0,0,417,16,0,0,0,4432,19704,4432,0,0
30,5/7/2020,456,19791,6,62,0,0,0,0,417,16,0,0,0,543,20247,543,0,0
30,5/8/2020,458,20487,6,62,0,0,0,0,420,16,0,0,2,696,20945,698,0,0
30,5/9/2020,458,20871,4,62,0,0,0,0,422,16,0,0,0,384,21329,384,0,0
30,5/10/2020,458,21246,4,62,0,0,0,0,422,16,0,0,0,375,21704,375,0,0
30,5/11/2020,459,22113,4,62,0,0,0,0,423,16,0,0,1,867,22572,868,0,0
30,5/12/2020,461,22574,4,63,0,0,0,0,425,16,0,0,2,461,23035,463,0,1
30,5/13/2020,462,23390,3,63,0,0,0,0,430,16,0,0,1,816,23852,817,0,0
30,5/14/2020,462,24087,3,63,0,0,0,0,431,16,0,0,0,697,24549,697,0,0
30,5/15/2020,466,24952,3,63,0,0,0,0,431,16,0,0,4,865,25418,869,0,0
30,5/16/2020,468,25623,3,63,0,0,0,0,431,16,0,0,2,671,26091,673,0,0
30,5/17/2020,468,26417,3,63,0,0,0,0,431,16,0,0,0,794,26885,794,0,0
30,5/18/2020,470,27697,4,64,0,0,0,0,434,16,0,0,2,1280,28167,1282,0,1
30,5/19/2020,471,28479,5,65,0,0,0,0,437,16,0,0,1,782,28950,783,0,1
30,5/20/2020,478,29248,3,65,0,0,0,0,440,16,0,0,7,769,29726,776,0,0
30,5/21/2020,479,30045,3,65,0,0,0,0,440,16,0,0,1,797,30524,798,0,0
30,5/22/2020,479,31378,3,65,0,0,0,0,441,16,0,0,0,1333,31857,1333,0,0
30,5/23/2020,479,32173,3,65,0,0,0,0,441,16,0,0,0,795,32652,795,0,0
30,5/24/2020,479,32902,3,65,0,0,0,0,441,16,0,0,0,729,33381,729,0,0
30,5/25/2020,479,33203,3,65,0,0,0,0,441,16,0,0,0,301,33682,301,0,0
30,5/26/2020,479,33355,2,65,0,0,0,0,441,17,0,0,0,152,33834,152,1,0
30,5/27/2020,481,35162,2,66,0,0,0,0,444,17,0,0,2,1807,35643,1809,0,1
30,5/28/2020,485,36308,1,66,0,0,0,0,445,17,0,0,4,1146,36793,1150,0,0
30,5/29/2020,493,38036,2,67,0,0,0,0,448,17,0,0,8,1728,38529,1736,0,1
30,5/30/2020,505,38779,2,67,0,0,0,0,448,17,0,0,12,743,39284,755,0,0
30,5/31/2020,515,39283,2,67,0,0,0,0,456,17,0,0,10,504,39798,514,0,0
30,6/1/2020,519,40138,2,67,0,0,0,0,461,17,0,0,4,855,40657,859,0,0
30,6/2/2020,523,41689,1,67,0,0,0,0,462,17,0,0,4,1551,42212,1555,0,0
30,6/3/2020,525,42923,1,68,0,0,0,0,464,17,0,0,2,1234,43448,1236,0,1
30,6/4/2020,539,44103,1,68,0,0,0,0,467,17,0,0,14,1180,44642,1194,0,0
30,6/5/2020,541,45347,1,68,0,0,0,0,470,18,0,0,2,1244,45888,1246,1,0
30,6/6/2020,540,46214,1,68,0,0,0,0,472,18,0,0,-1,867,46754,866,0,0
30,6/7/2020,545,46833,2,69,0,0,0,0,475,18,0,0,5,619,47378,624,0,1
30,6/8/2020,548,51044,2,69,0,0,0,0,475,18,0,0,3,4211,51592,4214,0,0
30,6/9/2020,554,52630,5,72,0,0,0,0,485,18,0,0,6,1586,53184,1592,0,3
30,6/10/2020,561,54055,7,74,0,0,0,0,487,18,0,0,7,1425,54616,1432,0,2
30,6/11/2020,563,55214,7,74,0,0,0,0,487,18,0,0,2,1159,55777,1161,0,0
30,6/12/2020,573,56449,7,77,0,0,0,0,489,18,0,0,10,1235,57022,1245,0,3
30,6/13/2020,588,57416,7,77,0,0,0,0,510,18,0,0,15,967,58004,982,0,0
30,6/14/2020,601,58306,6,77,0,0,0,0,510,19,0,0,13,890,58907,903,1,0
30,6/15/2020,609,60328,7,78,0,0,0,0,510,19,0,0,8,2022,60937,2030,0,1
30,6/16/2020,614,62963,8,79,0,0,0,0,535,19,0,0,5,2635,63577,2640,0,1
30,6/17/2020,630,64885,5,78,0,0,0,0,538,20,0,0,16,1922,65515,1938,1,-1
30,6/18/2020,655,66215,8,81,0,0,0,0,545,20,0,0,25,1330,66870,1355,0,3
30,6/19/2020,666,67756,9,82,0,0,0,0,546,20,0,0,11,1541,68422,1552,0,1
30,6/20/2020,698,68832,10,85,0,0,0,0,548,20,0,0,32,1076,69530,1108,0,3
30,6/21/2020,717,69640,15,89,0,0,0,0,548,20,0,0,19,808,70357,827,0,4
30,6/22/2020,740,70565,15,90,0,0,0,0,548,21,0,0,23,925,71305,948,1,1
30,6/23/2020,743,73180,15,91,0,0,0,0,566,21,0,0,3,2615,73923,2618,0,1
30,6/24/2020,766,74300,17,93,0,0,0,0,571,21,0,0,23,1120,75066,1143,0,2
30,6/25/2020,803,77529,15,93,0,0,0,0,572,21,0,0,37,3229,78332,3266,0,0
30,6/26/2020,829,79332,14,95,0,0,0,0,589,22,0,0,26,1803,80161,1829,1,2
30,6/27/2020,852,80395,9,95,0,0,0,0,604,22,0,0,23,1063,81247,1086,0,0
30,6/28/2020,863,81611,11,97,0,0,0,0,604,22,0,0,11,1216,82474,1227,0,2
30,6/29/2020,919,87824,13,100,0,0,0,0,609,22,0,0,56,6213,88743,6269,0,3
30,6/30/2020,967,89894,12,101,0,0,0,0,642,22,0,0,48,2070,90861,2118,0,1
30,7/1/2020,1016,92314,14,105,0,0,0,0,658,22,0,0,49,2420,93330,2469,0,4
30,7/2/2020,1083,94066,14,106,0,0,0,0,672,22,0,0,67,1752,95149,1819,0,1
30,7/3/2020,1128,96375,17,109,0,0,0,0,678,23,0,0,45,2309,97503,2354,1,3
30,7/4/2020,1167,97783,20,112,0,0,0,0,678,23,0,0,39,1408,98950,1447,0,3
30,7/5/2020,1212,98894,20,112,0,0,0,0,678,23,0,0,45,1111,100106,1156,0,0
30,7/6/2020,1249,101677,20,112,0,0,0,0,678,23,0,0,37,2783,102926,2820,0,0
30,7/7/2020,1327,104000,22,117,0,0,0,0,716,23,0,0,78,2323,105327,2401,0,5
30,7/8/2020,1371,105050,22,117,0,0,0,0,759,23,0,0,44,1050,106421,1094,0,0
30,7/9/2020,1466,107299,24,120,0,0,0,0,796,25,0,0,95,2249,108765,2344,2,3
30,7/10/2020,1593,110585,21,123,0,0,0,0,855,28,0,0,127,3286,112178,3413,3,3
30,7/11/2020,1677,111682,24,127,0,0,0,0,864,29,0,0,84,1097,113359,1181,1,4
30,7/12/2020,1758,112903,26,128,0,0,0,0,865,29,0,0,81,1221,114661,1302,0,1
30,7/13/2020,1843,116852,28,133,0,0,0,0,875,32,0,0,85,3949,118695,4034,3,5
30,7/14/2020,1952,119444,29,136,0,0,0,0,884,34,0,0,109,2592,121396,2701,2,3
30,7/15/2020,2096,121662,37,145,0,0,0,0,915,34,0,0,144,2218,123758,2362,0,9
30,7/16/2020,2231,125609,37,150,0,0,0,0,970,35,0,0,135,3947,127840,4082,1,5
30,7/17/2020,2366,128038,45,159,0,0,0,0,992,37,0,0,135,2429,130404,2564,2,9
31,3/5/2020,0,17,0,0,0,0,0,0,0,0,0,0,0,0,17,0,0,0
31,3/6/2020,0,17,0,0,0,0,0,0,0,0,0,0,0,0,17,0,0,0
31,3/7/2020,1,17,0,0,0,0,0,0,0,0,0,0,1,0,18,1,0,0
31,3/8/2020,1,17,0,0,0,0,0,0,0,0,0,0,0,0,18,0,0,0
31,3/9/2020,3,36,0,0,0,0,0,0,0,0,0,0,2,19,39,21,0,0
31,3/10/2020,3,47,0,0,0,0,0,0,0,0,0,0,0,11,50,11,0,0
31,3/11/2020,5,47,0,0,0,0,0,0,0,0,0,0,2,0,52,2,0,0
31,3/12/2020,10,80,0,0,0,0,0,0,0,0,0,0,5,33,90,38,0,0
31,3/13/2020,13,80,0,0,0,0,0,0,0,0,0,0,3,0,93,3,0,0
31,3/14/2020,14,80,0,0,0,0,0,0,0,0,0,0,1,0,94,1,0,0
31,3/15/2020,17,80,0,0,0,0,0,0,0,0,0,0,3,0,97,3,0,0
31,3/16/2020,18,170,0,0,0,0,0,0,0,0,0,0,1,90,188,91,0,0
31,3/17/2020,21,206,0,0,0,0,0,0,0,0,0,0,3,36,227,39,0,0
31,3/18/2020,24,206,0,0,0,0,0,0,0,0,0,0,3,0,230,3,0,0
31,3/19/2020,27,240,0,0,0,0,0,0,0,0,0,0,3,34,267,37,0,0
31,3/20/2020,32,240,0,0,0,0,0,0,0,0,0,0,5,0,272,5,0,0
31,3/21/2020,38,356,0,0,0,0,0,0,0,0,0,0,6,116,394,122,0,0
31,3/22/2020,48,356,0,0,0,0,0,0,0,0,0,0,10,0,404,10,0,0
31,3/23/2020,50,356,0,0,0,0,0,0,0,0,0,0,2,0,406,2,0,0
31,3/24/2020,52,975,0,0,0,0,0,0,0,0,0,0,2,619,1027,621,0,0
31,3/25/2020,61,1304,0,0,0,0,0,0,0,0,0,0,9,329,1365,338,0,0
31,3/26/2020,73,1584,0,0,0,0,0,0,0,0,0,0,12,280,1657,292,0,0
31,3/27/2020,85,1761,0,0,0,0,0,0,0,0,0,0,12,177,1846,189,0,0
31,3/28/2020,96,1904,0,0,0,0,0,0,0,2,0,0,11,143,2000,154,2,0
31,3/29/2020,108,1968,0,0,0,0,0,0,0,2,0,0,12,64,2076,76,0,0
31,3/30/2020,145,2584,0,0,0,0,0,0,0,2,0,0,37,616,2729,653,0,0
31,3/31/2020,172,2931,0,0,0,0,0,0,0,3,0,0,27,347,3103,374,1,0
31,4/1/2020,210,3475,0,0,0,0,0,0,0,4,0,0,38,544,3685,582,1,0
31,4/2/2020,246,3978,0,0,0,0,0,0,0,5,0,0,36,503,4224,539,1,0
31,4/3/2020,279,4487,0,0,0,0,0,0,0,6,0,0,33,509,4766,542,1,0
31,4/4/2020,321,5058,0,0,0,0,0,0,0,6,0,0,42,571,5379,613,0,0
31,4/5/2020,363,5558,0,0,0,0,0,0,0,8,0,0,42,500,5921,542,2,0
31,4/6/2020,409,6378,0,0,0,0,0,0,0,8,0,0,46,820,6787,866,0,0
31,4/7/2020,447,6811,0,0,0,0,0,0,0,10,0,0,38,433,7258,471,2,0
31,4/8/2020,519,7442,0,0,0,0,0,0,0,12,0,0,72,631,7961,703,2,0
31,4/9/2020,567,8116,0,0,0,0,0,0,0,14,0,0,48,674,8683,722,2,0
31,4/10/2020,635,8719,0,0,0,0,0,0,0,15,0,0,68,603,9354,671,1,0
31,4/11/2020,700,9285,0,0,0,0,0,0,0,17,0,0,65,566,9985,631,2,0
31,4/12/2020,791,9900,0,0,0,0,0,0,0,17,0,0,91,615,10691,706,0,0
31,4/13/2020,814,10158,0,0,0,0,0,0,0,17,0,0,23,258,10972,281,0,0
31,4/14/2020,871,10486,0,0,0,0,0,0,0,18,0,0,57,328,11357,385,1,0
31,4/15/2020,901,10828,0,0,0,0,0,0,0,20,0,0,30,342,11729,372,2,0
31,4/16/2020,952,11342,0,0,0,0,0,0,0,21,0,0,51,514,12294,565,1,0
31,4/17/2020,1066,12038,0,0,0,0,0,0,0,24,0,0,114,696,13104,810,3,0
31,4/18/2020,1138,12539,0,0,0,0,0,0,0,24,0,0,72,501,13677,573,0,0
31,4/19/2020,1287,13288,0,0,0,0,0,0,0,28,0,0,149,749,14575,898,4,0
31,4/20/2020,1474,14206,0,0,0,0,0,0,0,28,0,0,187,918,15680,1105,0,0
31,4/21/2020,1648,14724,0,0,0,0,0,0,0,33,0,0,174,518,16372,692,5,0
31,4/22/2020,1722,14957,0,0,0,0,0,0,0,38,0,0,74,233,16679,307,5,0
31,4/23/2020,1813,15547,0,0,0,0,0,0,0,45,0,0,91,590,17360,681,7,0
31,4/24/2020,2124,16488,0,0,0,0,0,0,0,47,0,0,311,941,18612,1252,2,0
31,4/25/2020,2421,17552,0,0,0,0,0,0,0,50,0,0,297,1064,19973,1361,3,0
31,4/26/2020,2732,18496,0,0,0,0,0,0,0,53,0,0,311,944,21228,1255,3,0
31,4/27/2020,3028,19335,0,0,0,0,0,0,0,56,0,0,296,839,22363,1135,3,0
31,4/28/2020,3358,20247,0,0,0,0,0,0,0,55,0,0,330,912,23605,1242,-1,0
31,4/29/2020,3374,20257,0,0,0,0,0,0,0,55,0,0,16,10,23631,26,0,0
31,4/30/2020,3784,21537,0,0,0,0,0,0,0,68,0,0,410,1280,25321,1690,13,0
31,5/1/2020,4281,23104,0,0,0,0,0,0,0,70,0,0,497,1567,27385,2064,2,0
31,5/2/2020,4838,24510,0,0,0,0,0,0,0,73,0,0,557,1406,29348,1963,3,0
31,5/3/2020,5326,25936,0,0,0,0,0,0,0,76,0,0,488,1426,31262,1914,3,0
31,5/4/2020,5910,27844,0,0,0,0,0,0,0,78,0,0,584,1908,33754,2492,2,0
31,5/5/2020,6083,28526,0,0,0,0,0,0,0,78,0,0,173,682,34609,855,0,0
31,5/6/2020,6438,29690,0,0,0,0,0,0,0,82,0,0,355,1164,36128,1519,4,0
31,5/7/2020,6771,30987,0,0,0,0,0,0,0,86,0,0,333,1297,37758,1630,4,0
31,5/8/2020,7190,33222,0,0,0,0,0,0,0,90,0,0,419,2235,40412,2654,4,0
31,5/9/2020,7831,35145,0,0,0,0,0,0,0,92,0,0,641,1923,42976,2564,2,0
31,5/10/2020,8234,37335,0,0,0,0,0,0,0,96,0,0,403,2190,45569,2593,4,0
31,5/11/2020,8315,37924,0,0,0,0,0,0,0,98,0,0,81,589,46239,670,2,0
31,5/12/2020,8572,39371,192,0,81,0,56,0,0,100,0,0,257,1447,47943,1704,2,0
31,5/13/2020,8692,41033,192,0,81,0,56,0,0,103,0,0,120,1662,49725,1782,3,0
31,5/14/2020,9075,44266,0,0,0,0,0,0,0,107,0,0,383,3233,53341,3616,4,0
31,5/15/2020,9416,47799,0,0,0,0,0,0,0,113,0,0,341,3533,57215,3874,6,0
31,5/16/2020,9772,50206,0,0,0,0,0,0,0,119,0,0,356,2407,59978,2763,6,0
31,5/17/2020,10220,55420,0,0,0,0,0,0,0,123,0,0,448,5214,65640,5662,4,0
31,5/18/2020,10348,57153,0,0,0,0,0,0,0,123,0,0,128,1733,67501,1861,0,0
31,5/19/2020,10625,59359,0,0,0,0,0,0,0,125,0,0,277,2206,69984,2483,2,0
31,5/20/2020,10846,61289,0,0,0,0,0,0,0,132,0,0,221,1930,72135,2151,7,0
31,5/21/2020,11122,64518,0,0,0,0,0,0,0,138,0,0,276,3229,75640,3505,6,0
31,5/22/2020,11425,66994,0,0,0,0,0,0,0,143,0,0,303,2476,78419,2779,5,0
31,5/23/2020,11662,68320,0,0,0,0,0,0,0,147,0,0,237,1326,79982,1563,4,0
31,5/24/2020,11989,71216,0,0,0,0,0,0,0,147,0,0,327,2896,83205,3223,0,0
31,5/25/2020,12134,73598,0,0,0,0,0,0,0,150,0,0,145,2382,85732,2527,3,0
31,5/26/2020,12355,75687,0,0,0,0,0,0,0,150,0,0,221,2089,88042,2310,0,0
31,5/27/2020,12619,77802,0,0,0,0,0,0,0,153,0,0,264,2115,90421,2379,3,0
31,5/28/2020,12976,80004,0,0,0,0,0,0,0,163,0,0,357,2202,92980,2559,10,0
31,5/29/2020,13261,81542,0,0,0,0,0,0,0,164,0,0,285,1538,94803,1823,1,0
31,5/30/2020,13654,85354,0,0,0,0,0,0,0,170,0,0,393,3812,99008,4205,6,0
31,5/31/2020,13905,87237,0,0,0,0,0,0,0,170,0,0,251,1883,101142,2134,0,0
31,6/1/2020,14101,89564,0,0,0,0,0,0,0,170,0,0,196,2327,103665,2523,0,0
31,6/2/2020,14345,92073,0,0,0,0,0,0,0,178,0,0,244,2509,106418,2753,8,0
31,6/3/2020,14611,95355,194,851,0,0,0,0,6743,181,0,0,266,3282,109966,3548,3,851
31,6/4/2020,14866,97389,211,902,0,0,0,0,7005,187,0,0,255,2034,112255,2289,6,51
31,6/5/2020,15117,99705,190,905,0,0,0,0,7598,186,0,0,251,2316,114822,2567,-1,3
31,6/6/2020,15379,102168,181,919,0,0,0,0,7957,186,0,0,262,2463,117547,2725,0,14
31,6/7/2020,15543,104226,167,928,0,0,0,0,8255,188,0,0,164,2058,119769,2222,2,9
31,6/8/2020,15634,105773,166,935,0,0,0,0,8455,188,0,0,91,1547,121407,1638,0,7
31,6/9/2020,15752,106940,176,967,0,0,0,0,8637,188,0,0,118,1167,122692,1285,0,32
31,6/10/2020,15883,109279,181,989,0,0,0,0,8820,191,0,0,131,2339,125162,2470,3,22
31,6/11/2020,16025,111637,175,1000,0,0,0,0,8946,195,0,0,142,2358,127662,2500,4,11
31,6/12/2020,16315,114458,164,1029,0,0,0,0,9229,212,0,0,290,2821,130773,3111,17,29
31,6/13/2020,16513,117864,157,1067,0,0,0,0,9610,216,0,0,198,3406,134377,3604,4,38
31,6/14/2020,16633,119482,156,1070,0,0,0,0,9879,216,0,0,120,1618,136115,1738,0,3
31,6/15/2020,16725,121030,160,1075,0,0,0,0,10121,216,0,0,92,1548,137755,1640,0,5
31,6/16/2020,16851,122662,160,1088,0,0,0,0,10351,220,0,0,126,1632,139513,1758,4,13
31,6/17/2020,17031,125356,156,1116,0,0,0,0,10529,231,0,0,180,2694,142387,2874,11,28
31,6/18/2020,17226,127587,156,1141,0,0,0,0,10761,234,0,0,195,2231,144813,2426,3,25
31,6/19/2020,17415,130431,149,1166,0,0,0,0,11066,240,0,0,189,2844,147846,3033,6,25
31,6/20/2020,17591,134263,141,1200,0,0,0,0,11312,244,0,0,176,3832,151854,4008,4,34
31,6/21/2020,17707,136534,140,1212,0,0,0,0,11565,244,0,0,116,2271,154241,2387,0,12
31,6/22/2020,17810,138698,141,1212,0,0,0,0,11776,244,0,0,103,2164,156508,2267,0,0
31,6/23/2020,17957,140685,135,1234,0,0,0,0,11980,249,0,0,147,1987,158642,2134,5,22
31,6/24/2020,18092,143209,125,1257,0,0,0,0,12099,256,0,0,135,2524,161301,2659,7,23
31,6/25/2020,18221,144949,131,1268,0,0,0,0,12099,257,0,0,129,1740,163170,1869,1,11
31,6/26/2020,18346,146656,126,1294,0,0,0,0,12314,260,0,0,125,1707,165002,1832,3,26
31,6/27/2020,18524,150074,125,1312,0,0,0,0,12698,266,0,0,178,3418,168598,3596,6,18
31,6/28/2020,18775,154023,123,1315,0,0,0,0,13053,267,0,0,251,3949,172798,4200,1,3
31,6/29/2020,18899,156373,117,1316,0,0,0,0,13322,267,0,0,124,2350,175272,2474,0,1
31,6/30/2020,19042,159115,121,1330,0,0,0,0,13547,269,0,0,143,2742,178157,2885,2,14
31,7/1/2020,19177,161431,120,1330,0,0,0,0,13737,274,0,0,135,2316,180608,2451,5,0
31,7/2/2020,19310,163352,117,1343,0,0,0,0,13807,276,0,0,133,1921,182662,2054,2,13
31,7/3/2020,19452,164682,121,1353,0,0,0,0,14022,282,0,0,142,1330,184134,1472,6,10
31,7/4/2020,19660,167928,111,1365,0,0,0,0,14200,284,0,0,208,3246,187588,3454,2,12
31,7/5/2020,19827,170101,109,1368,0,0,0,0,14340,284,0,0,167,2173,189928,2340,0,3
31,7/6/2020,19929,171811,101,1369,0,0,0,0,14641,284,0,0,102,1710,191740,1812,0,1
31,7/7/2020,20046,173027,109,1369,0,0,0,0,14759,283,0,0,117,1216,193073,1333,-1,0
31,7/8/2020,20201,174847,102,1398,0,0,0,0,14927,282,0,0,155,1820,195048,1975,-1,29
31,7/9/2020,20425,177410,97,1405,0,0,0,0,15031,282,0,0,224,2563,197835,2787,0,7
31,7/10/2020,20623,180391,100,1419,0,0,0,0,15206,284,0,0,198,2981,201014,3179,2,14
31,7/11/2020,20777,183077,95,1419,0,0,0,0,15499,286,0,0,154,2686,203854,2840,2,0
31,7/12/2020,20998,187105,95,1421,0,0,0,0,15724,285,0,0,221,4028,208103,4249,-1,2
31,7/13/2020,21172,190487,98,1421,0,0,0,0,15860,285,0,0,174,3382,211659,3556,0,0
31,7/14/2020,21399,194836,101,1431,0,0,0,0,16025,288,0,0,227,4349,216235,4576,3,10
31,7/15/2020,21717,198026,110,1442,0,0,0,0,16205,286,0,0,318,3190,219743,3508,-2,11
31,7/16/2020,21979,201250,103,1453,0,0,0,0,16324,291,0,0,262,3224,223229,3486,5,11
31,7/17/2020,22134,204062,96,1453,0,0,0,0,16501,299,0,0,155,2812,226196,2967,8,0
32,3/5/2020,1,14,0,0,0,0,0,0,0,0,0,0,0,0,15,0,0,0
32,3/6/2020,1,14,0,0,0,0,0,0,0,0,0,0,0,0,15,0,0,0
32,3/7/2020,1,14,0,0,0,0,0,0,0,0,0,0,0,0,15,0,0,0
32,3/8/2020,1,14,0,0,0,0,0,0,0,0,0,0,0,0,15,0,0,0
32,3/9/2020,1,14,0,0,0,0,0,0,0,0,0,0,0,0,15,0,0,0
32,3/10/2020,1,14,0,0,0,0,0,0,0,0,0,0,0,0,15,0,0,0
32,3/11/2020,5,168,0,0,0,0,0,0,0,0,0,0,4,154,173,158,0,0
32,3/12/2020,7,168,0,0,0,0,0,0,0,0,0,0,2,0,175,2,0,0
32,3/13/2020,11,168,0,0,0,0,0,0,0,0,0,0,4,0,179,4,0,0
32,3/14/2020,20,168,0,0,0,0,0,0,0,0,0,0,9,0,188,9,0,0
32,3/15/2020,21,168,0,0,0,0,0,0,0,1,0,0,1,0,189,1,1,0
32,3/16/2020,45,168,0,0,0,0,0,0,0,1,0,0,24,0,213,24,0,0
32,3/17/2020,55,168,0,0,0,0,0,0,0,1,0,0,10,0,223,10,0,0
32,3/18/2020,55,168,0,0,0,0,0,0,0,2,0,0,0,0,223,0,1,0
32,3/19/2020,95,1626,0,0,0,0,0,0,0,3,0,0,40,1458,1721,1498,1,0
32,3/20/2020,109,1992,0,0,0,0,0,0,0,3,0,0,14,366,2101,380,0,0
32,3/21/2020,124,2384,0,0,0,0,0,0,0,5,0,0,15,392,2508,407,2,0
32,3/22/2020,190,2448,0,0,0,0,0,0,0,7,0,0,66,64,2638,130,2,0
32,3/23/2020,245,3490,0,0,0,0,0,0,0,8,0,0,55,1042,3735,1097,1,0
32,3/24/2020,278,3954,0,0,0,0,0,0,0,13,0,0,33,464,4232,497,5,0
32,3/25/2020,321,4251,0,0,0,0,0,0,0,13,0,0,43,297,4572,340,0,0
32,3/26/2020,420,4697,0,0,0,0,0,0,0,17,0,0,99,446,5117,545,4,0
32,3/27/2020,535,6161,0,0,0,0,0,0,0,21,0,0,115,1464,6696,1579,4,0
32,3/28/2020,621,7901,0,0,0,0,0,0,0,25,0,0,86,1740,8522,1826,4,0
32,3/29/2020,738,8412,0,0,0,0,0,0,0,28,0,0,117,511,9150,628,3,0
32,3/30/2020,1008,10207,0,0,0,0,0,0,0,32,0,0,270,1795,11215,2065,4,0
32,3/31/2020,1113,10681,0,0,0,0,0,0,0,37,0,0,105,474,11794,579,5,0
32,4/1/2020,1279,11519,0,0,0,0,0,0,0,45,0,0,166,838,12798,1004,8,0
32,4/2/2020,1458,12588,0,0,0,0,0,0,0,51,0,0,179,1069,14046,1248,6,0
32,4/3/2020,1514,13018,0,0,0,0,0,0,0,59,0,0,56,430,14532,486,8,0
32,4/4/2020,1742,14421,0,0,0,0,0,0,0,70,0,0,228,1403,16163,1631,11,0
32,4/5/2020,1836,14995,0,0,0,0,0,0,0,76,0,0,94,574,16831,668,6,0
32,4/6/2020,1953,15676,0,0,0,0,0,0,0,79,0,0,117,681,17629,798,3,0
32,4/7/2020,2087,16552,282,0,0,0,0,0,0,91,0,0,134,876,18639,1010,12,0
32,4/8/2020,2318,18248,282,0,0,0,0,0,0,101,0,0,231,1696,20566,1927,10,0
32,4/9/2020,2456,19315,282,0,0,0,0,0,0,110,0,0,138,1067,21771,1205,9,0
32,4/10/2020,2584,20165,282,0,0,0,0,0,0,120,0,0,128,850,22749,978,10,0
32,4/11/2020,2700,20887,282,0,0,0,0,0,0,125,0,0,116,722,23587,838,5,0
32,4/12/2020,2836,21775,282,0,0,0,0,0,0,128,0,0,136,888,24611,1024,3,0
32,4/13/2020,2971,22493,0,0,0,0,0,0,0,133,0,0,135,718,25464,853,5,0
32,4/14/2020,3088,23573,0,0,0,0,0,0,0,141,0,0,117,1080,26661,1197,8,0
32,4/15/2020,3211,24444,0,0,0,0,0,0,0,150,0,0,123,871,27655,994,9,0
32,4/16/2020,3321,25130,0,0,0,0,0,0,0,158,0,0,110,686,28451,796,8,0
32,4/17/2020,3524,26238,0,0,0,0,0,0,0,162,0,0,203,1108,29762,1311,4,0
32,4/18/2020,3626,27125,0,0,0,0,0,0,0,168,0,0,102,887,30751,989,6,0
32,4/19/2020,3728,27870,0,0,0,0,0,0,0,172,0,0,102,745,31598,847,4,0
32,4/20/2020,3830,28517,0,0,0,0,0,0,0,180,0,0,102,647,32347,749,8,0
32,4/21/2020,3937,29118,0,0,0,0,0,0,0,193,0,0,107,601,33055,708,13,0
32,4/22/2020,4081,29807,0,0,0,0,0,0,0,201,0,0,144,689,33888,833,8,0
32,4/23/2020,4208,30541,0,0,0,0,0,0,0,210,0,0,127,734,34749,861,9,0
32,4/24/2020,4398,31794,0,0,0,0,0,0,0,216,0,0,190,1253,36192,1443,6,0
32,4/25/2020,4539,32669,0,0,0,0,0,0,0,229,0,0,141,875,37208,1016,13,0
32,4/26/2020,4602,33584,0,0,0,0,0,0,0,235,0,0,63,915,38186,978,6,0
32,4/27/2020,4690,34123,0,0,0,0,0,0,0,245,0,0,88,539,38813,627,10,0
32,4/28/2020,4805,35314,0,0,0,0,0,0,0,251,0,0,115,1191,40119,1306,6,0
32,4/29/2020,4898,36130,0,0,0,0,0,0,100,257,0,0,93,816,41028,909,6,0
32,4/30/2020,4998,36988,0,0,0,0,0,0,158,269,0,0,100,858,41986,958,12,0
32,5/1/2020,5227,38368,0,0,0,0,0,0,182,277,0,0,229,1380,43595,1609,8,0
32,5/2/2020,5311,39076,0,0,0,0,0,0,182,281,0,0,84,708,44387,792,4,0
32,5/3/2020,5426,39843,0,0,0,0,0,0,182,287,0,0,115,767,45269,882,6,0
32,5/4/2020,5491,40675,0,0,0,0,0,0,185,292,0,0,65,832,46166,897,5,0
32,5/5/2020,5594,42290,0,0,0,0,0,0,200,297,0,0,103,1615,47884,1718,5,0
32,5/6/2020,5663,43612,0,0,0,0,0,0,203,311,0,0,69,1322,49275,1391,14,0
32,5/7/2020,5766,45591,0,0,0,0,0,0,205,320,0,0,103,1979,51357,2082,9,0
32,5/8/2020,5884,47460,0,0,0,0,0,0,205,328,0,0,118,1869,53344,1987,8,0
32,5/9/2020,6028,50083,0,0,0,0,0,0,205,334,0,0,144,2623,56111,2767,6,0
32,5/10/2020,6098,52711,444,0,116,0,65,0,182,339,0,0,70,2628,58809,2698,5,0
32,5/11/2020,6152,53932,482,0,117,0,60,0,183,344,0,0,54,1221,60084,1275,5,0
32,5/12/2020,6311,57764,522,0,121,0,64,0,185,350,0,0,159,3832,64075,3991,6,0
32,5/13/2020,6394,60278,522,0,121,0,64,0,198,355,0,0,83,2514,66672,2597,5,0
32,5/14/2020,6499,62985,515,0,126,0,75,0,244,358,0,0,105,2707,69484,2812,3,0
32,5/15/2020,6614,65532,425,0,115,0,73,0,272,368,0,0,115,2547,72146,2662,10,0
32,5/16/2020,6662,67002,423,0,105,0,65,0,272,369,0,0,48,1470,73664,1518,1,0
32,5/17/2020,6857,73780,423,0,105,0,65,0,272,375,0,0,195,6778,80637,6973,6,0
32,5/18/2020,6906,74926,423,0,105,0,65,0,355,383,0,0,49,1146,81832,1195,8,0
32,5/19/2020,7046,80509,405,0,106,0,54,0,334,390,0,0,140,5583,87555,5723,7,0
32,5/20/2020,7166,84005,437,0,107,0,60,0,336,393,0,0,120,3496,91171,3616,3,0
32,5/21/2020,7255,87127,410,0,92,0,52,0,339,397,0,0,89,3122,94382,3211,4,0
32,5/22/2020,7401,92540,404,0,90,0,51,0,339,400,0,0,146,5413,99941,5559,3,0
32,5/23/2020,7696,99351,402,0,99,0,53,0,359,404,0,0,295,6811,107047,7106,4,0
32,5/24/2020,7770,102511,373,0,92,0,51,0,359,408,0,0,74,3160,110281,3234,4,0
32,5/25/2020,7879,106852,380,0,91,0,45,0,359,410,0,0,109,4341,114731,4450,2,0
32,5/26/2020,7997,115370,390,0,91,0,46,0,374,412,0,0,118,8518,123367,8636,2,0
32,5/27/2020,8113,120446,435,0,108,0,48,0,401,416,0,0,116,5076,128559,5192,4,0
32,5/28/2020,8208,122982,439,0,123,0,55,0,406,425,0,0,95,2536,131190,2631,9,0
32,5/29/2020,8350,126066,371,0,92,0,42,0,428,435,0,0,142,3084,134416,3226,10,0
32,5/30/2020,8495,130037,371,0,92,0,42,0,428,439,0,0,145,3971,138532,4116,4,0
32,5/31/2020,8593,133967,336,0,71,0,41,0,428,444,0,0,98,3930,142560,4028,5,0
32,6/1/2020,8688,138095,361,0,87,0,40,0,459,445,0,0,95,4128,146783,4223,1,0
32,6/2/2020,8830,143261,365,0,88,0,39,0,464,452,0,0,142,5166,152091,5308,7,0
32,6/3/2020,8935,147320,372,0,84,0,47,0,501,455,0,0,105,4059,156255,4164,3,0
32,6/4/2020,9090,152333,364,0,79,0,47,0,512,460,0,0,155,5013,161423,5168,5,0
32,6/5/2020,9266,156841,341,0,72,0,47,0,522,460,0,0,176,4508,166107,4684,0,0
32,6/6/2020,9460,162311,348,0,80,0,44,0,522,463,0,0,194,5470,171771,5664,3,0
32,6/7/2020,9649,166048,348,0,80,0,44,0,522,465,0,0,189,3737,175697,3926,2,0
32,6/8/2020,9786,170217,339,0,74,0,44,0,522,469,0,0,137,4169,180003,4306,4,0
32,6/9/2020,10030,173559,350,0,86,0,41,0,557,472,0,0,244,3342,183589,3586,3,0
32,6/10/2020,10164,177159,359,0,70,0,38,0,557,474,0,0,134,3600,187323,3734,2,0
32,6/11/2020,10399,182855,337,0,72,0,35,0,560,475,0,0,235,5696,193254,5931,1,0
32,6/12/2020,10678,188769,328,0,77,0,36,0,604,475,0,0,279,5914,199447,6193,0,0
32,6/13/2020,10946,193934,351,0,81,0,43,0,627,478,0,0,268,5165,204880,5433,3,0
32,6/14/2020,11173,199438,332,0,83,0,69,0,627,479,0,0,227,5504,210611,5731,1,0
32,6/15/2020,11279,205155,346,0,85,0,40,0,636,483,0,0,106,5717,216434,5823,4,0
32,6/16/2020,11658,210816,349,0,87,0,48,0,640,485,0,0,379,5661,222474,6040,2,0
32,6/17/2020,11842,215768,360,0,96,0,45,0,640,486,0,0,184,4952,227610,5136,1,0
32,6/18/2020,12076,218720,357,0,93,0,55,0,641,489,0,0,234,2952,230796,3186,3,0
32,6/19/2020,12486,221874,370,0,87,0,49,0,652,491,0,0,410,3154,234360,3564,2,0
32,6/20/2020,12931,226032,370,0,87,0,49,0,652,491,0,0,445,4158,238963,4603,0,0
32,6/21/2020,13205,228486,370,0,87,0,49,0,652,492,0,0,274,2454,241691,2728,1,0
32,6/22/2020,13535,230530,373,0,100,0,46,0,653,492,0,0,330,2044,244065,2374,0,0
32,6/23/2020,13997,234529,389,0,100,0,50,0,658,492,0,0,462,3999,248526,4461,0,0
32,6/24/2020,14362,238025,439,0,96,0,53,0,666,494,0,0,365,3496,252387,3861,2,0
32,6/25/2020,14859,240691,467,0,98,0,57,0,682,495,0,0,497,2666,255550,3163,1,0
32,6/26/2020,15240,243422,471,0,118,0,59,0,684,498,0,0,381,2731,258662,3112,3,0
32,6/27/2020,16339,246687,503,0,117,0,66,0,684,500,0,0,1099,3265,263026,4364,2,0
32,6/28/2020,17160,250420,511,0,122,0,59,0,684,500,0,0,821,3733,267580,4554,0,0
32,6/29/2020,17894,255123,555,0,124,0,65,0,689,504,0,0,734,4703,273017,5437,4,0
32,6/30/2020,18456,259112,593,0,134,0,65,0,689,507,0,0,562,3989,277568,4551,3,0
32,7/1/2020,19101,264995,630,0,142,0,74,0,714,511,0,0,645,5883,284096,6528,4,0
32,7/2/2020,19733,264995,662,0,196,0,78,0,727,525,0,0,632,0,284728,632,14,0
32,7/3/2020,20718,272967,704,0,219,0,87,0,727,528,0,0,985,7972,293685,8957,3,0
32,7/4/2020,21575,279654,749,0,205,0,97,0,727,530,0,0,857,6687,301229,7544,2,0
32,7/5/2020,22418,285279,760,0,226,0,99,0,727,534,0,0,843,5625,307697,6468,4,0
32,7/6/2020,22909,288572,748,0,201,0,114,0,742,537,0,0,491,3293,311481,3784,3,0
32,7/7/2020,23785,292761,849,0,236,0,112,0,743,548,0,0,876,4189,316546,5065,11,0
32,7/8/2020,24301,299352,876,0,233,0,109,0,754,553,0,0,516,6591,323653,7107,5,0
32,7/9/2020,24904,304874,935,0,237,0,112,0,759,571,0,0,603,5522,329778,6125,18,0
32,7/10/2020,25908,309583,924,0,248,0,111,0,764,579,0,0,1004,4709,335491,5713,8,0
32,7/11/2020,26838,314395,918,0,241,0,122,0,764,592,0,0,930,4812,341233,5742,13,0
32,7/12/2020,27683,319873,895,0,239,0,114,0,764,593,0,0,845,5478,347556,6323,1,0
32,7/13/2020,28515,324678,953,0,250,0,107,0,789,593,0,0,832,4805,353193,5637,0,0
32,7/14/2020,29619,330561,983,0,247,0,121,0,800,612,0,0,1104,5883,360180,6987,19,0
32,7/15/2020,30468,333957,1051,0,251,0,124,0,826,618,0,0,849,3396,364425,4245,6,0
32,7/16/2020,31915,338928,1051,0,251,0,124,0,834,626,0,0,1447,4971,370843,6418,8,0
32,7/17/2020,33295,343712,1000,0,269,0,134,0,842,637,0,0,1380,4784,377007,6164,11,0
33,3/4/2020,2,10,0,0,0,0,0,0,0,0,0,0,0,0,12,0,0,0
33,3/5/2020,2,16,0,0,0,0,0,0,0,0,0,0,0,6,18,6,0,0
33,3/6/2020,2,20,0,0,0,0,0,0,0,0,0,0,0,4,22,4,0,0
33,3/7/2020,2,20,0,0,0,0,0,0,0,0,0,0,0,0,22,0,0,0
33,3/8/2020,4,38,0,0,0,0,0,0,0,0,0,0,2,18,42,20,0,0
33,3/9/2020,4,38,0,0,0,0,0,0,0,0,0,0,0,0,42,0,0,0
33,3/10/2020,4,38,0,0,0,0,0,0,0,0,0,0,0,0,42,0,0,0
33,3/11/2020,4,38,0,0,0,0,0,0,0,0,0,0,0,0,42,0,0,0
33,3/12/2020,6,94,0,0,0,0,0,0,0,0,0,0,2,56,100,58,0,0
33,3/13/2020,6,94,0,0,0,0,0,0,0,0,0,0,0,0,100,0,0,0
33,3/14/2020,7,212,0,0,0,0,0,0,0,0,0,0,1,118,219,119,0,0
33,3/15/2020,13,271,0,0,0,0,0,0,0,0,0,0,6,59,284,65,0,0
33,3/16/2020,13,271,0,0,0,0,0,0,0,0,0,0,0,0,284,0,0,0
33,3/17/2020,17,355,0,0,0,0,0,0,0,0,0,0,4,84,372,88,0,0
33,3/18/2020,26,513,0,0,0,0,0,0,0,0,0,0,9,158,539,167,0,0
33,3/19/2020,39,621,0,0,0,0,0,0,0,0,0,0,13,108,660,121,0,0
33,3/20/2020,44,745,0,0,0,0,0,0,0,0,0,0,5,124,789,129,0,0
33,3/21/2020,55,973,0,0,0,0,0,0,0,0,0,0,11,228,1028,239,0,0
33,3/22/2020,65,1188,0,0,0,0,0,0,0,0,0,0,10,215,1253,225,0,0
33,3/23/2020,78,1374,0,0,0,0,0,0,0,0,0,0,13,186,1452,199,0,0
33,3/24/2020,101,1447,0,11,0,0,0,0,0,1,0,0,23,73,1548,96,1,11
33,3/25/2020,108,2356,0,13,0,0,0,0,0,1,0,0,7,909,2464,916,0,2
33,3/26/2020,137,3001,0,19,0,0,0,0,0,1,0,0,29,645,3138,674,0,6
33,3/27/2020,158,3395,0,25,0,0,0,0,0,1,0,0,21,394,3553,415,0,6
33,3/28/2020,187,3656,0,30,0,0,0,0,0,2,0,0,29,261,3843,290,1,5
33,3/29/2020,214,4524,0,33,0,0,0,0,0,2,0,0,27,868,4738,895,0,3
33,3/30/2020,314,5386,0,45,0,0,0,0,0,3,0,0,100,862,5700,962,1,12
33,3/31/2020,314,5413,0,45,0,0,0,0,0,3,0,0,0,27,5727,27,0,0
33,4/1/2020,415,5985,0,56,0,0,0,0,56,4,0,0,101,572,6400,673,1,11
33,4/2/2020,415,6078,0,58,0,0,0,0,91,4,0,0,0,93,6493,93,0,2
33,4/3/2020,479,6575,0,73,0,0,0,0,101,5,0,0,64,497,7054,561,1,15
33,4/4/2020,540,6965,0,80,0,0,0,0,144,7,0,0,61,390,7505,451,2,7
33,4/5/2020,621,7411,0,86,0,0,0,0,146,9,0,0,81,446,8032,527,2,6
33,4/6/2020,669,7701,0,92,0,0,0,0,147,9,0,0,48,290,8370,338,0,6
33,4/7/2020,715,8019,0,103,0,0,0,0,151,9,0,0,46,318,8734,364,0,11
33,4/8/2020,788,8389,0,118,0,0,0,0,211,18,0,0,73,370,9177,443,9,15
33,4/9/2020,788,8763,0,118,0,0,0,0,227,18,0,0,0,374,9551,374,0,0
33,4/10/2020,819,9139,0,124,0,0,0,0,234,21,0,0,31,376,9958,407,3,6
33,4/11/2020,885,9608,0,134,0,0,0,0,234,22,0,0,66,469,10493,535,1,10
33,4/12/2020,929,9996,0,146,0,0,0,0,236,23,0,0,44,388,10925,432,1,12
33,4/13/2020,985,10222,0,152,0,0,0,0,239,23,0,0,56,226,11207,282,0,6
33,4/14/2020,1020,10590,72,152,0,0,0,0,249,23,0,0,35,368,11610,403,0,0
33,4/15/2020,1139,11027,70,178,0,0,0,0,365,32,0,0,119,437,12166,556,9,26
33,4/16/2020,1139,11027,70,178,0,0,0,0,365,32,0,0,0,0,12166,0,0,0
33,4/17/2020,1287,11421,74,190,0,0,0,0,455,37,0,0,148,394,12708,542,5,12
33,4/18/2020,1287,11565,86,190,0,0,0,0,468,37,0,0,0,144,12852,144,0,0
33,4/19/2020,1342,12082,85,192,0,0,0,0,513,38,0,0,55,517,13424,572,1,2
33,4/20/2020,1392,12726,79,198,0,0,0,0,521,41,0,0,50,644,14118,694,3,6
33,4/21/2020,1491,12848,78,206,0,0,0,0,521,42,0,0,99,122,14339,221,1,8
33,4/22/2020,1491,13550,94,206,0,0,0,0,546,42,0,0,0,702,15041,702,0,0
33,4/23/2020,1588,14424,91,213,0,0,0,0,550,48,0,0,97,874,16012,971,6,7
33,4/24/2020,1670,15139,92,218,0,0,0,0,551,51,0,0,82,715,16809,797,3,5
33,4/25/2020,1720,16007,89,224,0,0,0,0,578,53,0,0,50,868,17727,918,2,6
33,4/26/2020,1787,16964,95,238,0,0,0,0,777,60,0,0,67,957,18751,1024,7,14
33,4/27/2020,1864,17860,101,242,0,0,0,0,779,60,0,0,77,896,19724,973,0,4
33,4/28/2020,1938,18207,99,246,0,0,0,0,798,60,0,0,74,347,20145,421,0,4
33,4/29/2020,2010,18736,106,249,0,0,0,0,936,60,0,0,72,529,20746,601,0,3
33,4/30/2020,2054,19867,107,259,0,0,0,0,980,66,0,0,44,1131,21921,1175,6,10
33,5/1/2020,2146,19903,112,262,0,0,0,0,980,72,0,0,92,36,22049,128,6,3
33,5/2/2020,2310,22039,103,270,0,0,0,0,980,81,0,0,164,2136,24349,2300,9,8
33,5/3/2020,2429,25964,103,277,0,0,0,0,1107,84,0,0,119,3925,28393,4044,3,7
33,5/4/2020,2588,24282,103,286,0,0,0,0,1017,86,0,0,159,-1682,26870,-1523,2,9
33,5/5/2020,2588,24282,111,286,0,82,0,0,1019,86,0,0,0,0,26870,0,0,0
33,5/6/2020,2636,25097,115,295,0,82,0,0,1105,92,0,0,48,815,27733,863,6,9
33,5/7/2020,2740,26066,113,307,0,82,0,0,1110,111,0,0,104,969,28806,1073,19,12
33,5/8/2020,2843,27829,113,308,0,97,0,0,1165,114,0,0,103,1763,30672,1866,3,1
33,5/9/2020,2947,29351,112,309,0,97,0,0,1210,121,0,0,104,1522,32298,1626,7,1
33,5/10/2020,3011,30442,107,313,0,97,0,0,1228,131,0,0,64,1091,33453,1155,10,4
33,5/11/2020,3160,31723,113,318,0,97,0,0,1229,133,0,0,149,1281,34883,1430,2,5
33,5/12/2020,3160,32401,117,318,0,97,0,0,1231,133,0,0,0,678,35561,678,0,0
33,5/13/2020,3239,33977,121,319,0,97,0,0,1234,142,0,0,79,1576,37216,1655,9,1
33,5/14/2020,3299,35876,126,326,0,97,0,0,1236,150,0,0,60,1899,39175,1959,8,7
33,5/15/2020,3464,39148,115,335,0,109,0,0,1247,159,0,0,165,3272,42612,3437,9,9
33,5/16/2020,3464,39212,110,335,0,109,0,0,1254,159,0,0,0,64,42676,64,0,0
33,5/17/2020,3556,41196,115,347,0,109,0,0,1258,171,0,0,92,1984,44752,2076,12,12
33,5/18/2020,3596,41282,114,359,0,109,0,0,1268,172,0,0,40,86,44878,126,1,12
33,5/19/2020,3652,45822,109,368,0,109,0,0,1269,172,0,0,56,4540,49474,4596,0,9
33,5/20/2020,3721,47167,105,383,0,109,0,0,1275,182,0,0,69,1345,50888,1414,10,15
33,5/21/2020,3868,48962,103,385,0,109,0,0,1388,190,0,0,147,1795,52830,1942,8,2
33,5/22/2020,3935,51165,97,393,0,120,0,0,1767,199,0,0,67,2203,55100,2270,9,8
33,5/23/2020,4089,55450,93,419,0,120,0,0,2197,208,0,0,154,4285,59539,4439,9,26
33,5/24/2020,4089,55450,93,419,0,120,0,0,2197,208,0,0,0,0,59539,0,0,0
33,5/25/2020,4149,57237,92,419,0,120,0,0,2204,209,0,0,60,1787,61386,1847,1,0
33,5/26/2020,4197,58842,91,420,0,120,0,0,2434,210,0,0,48,1605,63039,1653,1,1
33,5/27/2020,4231,60001,91,421,0,120,0,0,2550,214,0,0,34,1159,64232,1193,4,1
33,5/28/2020,4286,61310,105,426,0,120,0,0,2691,223,0,0,55,1309,65596,1364,9,5
33,5/29/2020,4386,62476,110,438,0,120,0,0,2730,232,0,0,100,1166,66862,1266,9,12
33,5/30/2020,4492,64468,105,440,0,120,0,0,2802,238,0,0,106,1992,68960,2098,6,2
33,5/31/2020,4545,65735,107,449,0,140,0,0,2940,242,0,0,53,1267,70280,1320,4,9
33,6/1/2020,4651,67805,96,451,0,141,0,0,2948,245,0,0,106,2070,72456,2176,3,2
33,6/2/2020,4685,69659,98,456,0,142,0,0,2954,245,0,0,34,1854,74344,1888,0,5
33,6/3/2020,4749,70990,97,462,0,142,0,0,3071,256,0,0,64,1331,75739,1395,11,6
33,6/4/2020,4795,71170,88,468,0,144,0,0,3157,265,0,0,46,180,75965,226,9,6
33,6/5/2020,4876,74889,86,472,0,145,0,0,3187,273,0,0,81,3719,79765,3800,8,4
33,6/6/2020,5019,78990,84,487,0,145,0,0,3319,283,0,0,143,4101,84009,4244,10,15
33,6/7/2020,5019,78990,84,487,0,145,0,0,3319,283,0,0,0,0,84009,0,0,0
33,6/8/2020,5043,80509,86,489,0,145,0,0,3392,286,0,0,24,1519,85552,1543,3,2
33,6/9/2020,5079,82044,78,492,0,145,0,0,3392,286,0,0,36,1535,87123,1571,0,3
33,6/10/2020,5132,83515,80,496,0,146,0,0,3501,294,0,0,53,1471,88647,1524,8,4
33,6/11/2020,5178,84729,81,500,0,147,0,0,3585,301,0,0,46,1214,89907,1260,7,4
33,6/12/2020,5209,86708,73,504,0,149,0,0,3665,308,0,0,31,1979,91917,2010,7,4
33,6/13/2020,5251,88705,76,503,0,149,0,0,3843,315,0,0,42,1997,93956,2039,7,-1
33,6/14/2020,5299,91122,70,513,0,152,0,0,3905,318,0,0,48,2417,96421,2465,3,10
33,6/15/2020,5345,93528,69,519,0,154,0,0,4041,320,0,0,46,2406,98873,2452,2,6
33,6/16/2020,5345,93528,69,519,0,154,0,0,4041,320,0,0,0,0,98873,0,0,0
33,6/17/2020,5364,94722,62,521,0,155,0,0,4067,326,0,0,19,1194,100086,1213,6,2
33,6/18/2020,5436,96548,56,531,0,156,0,0,4104,330,0,0,72,1826,101984,1898,4,10
33,6/19/2020,5450,98275,56,533,0,158,0,0,4140,331,0,0,14,1727,103725,1741,1,2
33,6/20/2020,5486,100081,61,549,0,159,0,0,4209,337,0,0,36,1806,105567,1842,6,16
33,6/21/2020,5518,100367,55,551,0,159,0,0,4244,339,0,0,32,286,105885,318,2,2
33,6/22/2020,5544,103318,55,553,0,159,0,0,4275,339,0,0,26,2951,108862,2977,0,2
33,6/23/2020,5558,103318,54,558,0,160,0,0,4290,339,0,0,14,0,108876,14,0,5
33,6/24/2020,5571,104482,51,558,0,160,0,0,4316,343,0,0,13,1164,110053,1177,4,0
33,6/25/2020,5598,105968,49,558,0,160,0,0,4358,347,0,0,27,1486,111566,1513,4,0
33,6/26/2020,5671,109097,32,561,0,161,0,0,4381,365,0,0,73,3129,114768,3202,18,3
33,6/27/2020,5671,109097,32,561,0,161,0,0,4381,365,0,0,0,0,114768,0,0,0
33,6/28/2020,5717,110392,35,562,0,162,0,0,4401,367,0,0,46,1295,116109,1341,2,1
33,6/29/2020,5760,112538,34,565,0,162,0,0,4435,367,0,0,43,2146,118298,2189,0,3
33,6/30/2020,5760,112538,34,565,0,162,0,0,4435,367,0,0,0,0,118298,0,0,0
33,7/1/2020,5782,113387,37,565,0,162,0,0,4463,371,0,0,22,849,119169,871,4,0
33,7/2/2020,5802,114505,32,565,0,162,0,0,4491,373,0,0,20,1118,120307,1138,2,0
33,7/3/2020,5822,116365,31,567,0,162,0,0,4508,375,0,0,20,1860,122187,1880,2,2
33,7/4/2020,5857,117892,25,569,0,163,0,0,4597,376,0,0,35,1527,123749,1562,1,2
33,7/5/2020,5857,117892,25,569,0,163,0,0,4597,376,0,0,0,0,123749,0,0,0
33,7/6/2020,5897,119338,25,570,0,163,0,0,4684,381,0,0,40,1446,125235,1486,5,1
33,7/7/2020,5914,121966,25,574,0,163,0,0,4706,382,0,0,17,2628,127880,2645,1,4
33,7/8/2020,5932,122579,24,577,0,164,0,0,4758,384,0,0,18,613,128511,631,2,3
33,7/9/2020,5952,123676,22,578,0,164,0,0,4817,386,0,0,20,1097,129628,1117,2,1
33,7/10/2020,5973,125078,24,581,0,189,0,0,4831,387,0,0,21,1402,131051,1423,1,3
33,7/11/2020,5991,126311,20,585,0,190,0,0,4897,390,0,0,18,1233,132302,1251,3,4
33,7/12/2020,6024,127365,22,589,0,191,0,0,5013,391,0,0,33,1054,133389,1087,1,4
33,7/13/2020,6054,128812,22,589,0,191,0,0,5027,391,0,0,30,1447,134866,1477,0,0
33,7/14/2020,6068,129960,24,589,0,191,0,0,5056,391,0,0,14,1148,136028,1162,0,0
33,7/15/2020,6091,131018,23,665,0,191,0,0,5101,392,0,0,23,1058,137109,1081,1,76
33,7/16/2020,6113,132159,24,668,0,192,0,0,5125,394,0,0,22,1141,138272,1163,2,3
33,7/17/2020,6165,135621,24,670,0,192,0,0,5188,395,0,0,52,3462,141786,3514,1,2
34,3/5/2020,1,0,0,0,0,0,0,0,0,0,0,0,0,0,1,0,0,0
34,3/6/2020,1,0,0,0,0,0,0,0,0,0,0,0,0,0,1,0,0,0
34,3/7/2020,4,0,0,0,0,0,0,0,0,0,0,0,3,0,4,3,0,0
34,3/8/2020,6,31,0,0,0,0,0,0,0,0,0,0,2,31,37,33,0,0
34,3/9/2020,11,35,0,0,0,0,0,0,0,0,0,0,5,4,46,9,0,0
34,3/10/2020,15,44,0,0,0,0,0,0,0,0,0,0,4,9,59,13,0,0
34,3/11/2020,24,57,0,0,0,0,0,0,0,1,0,0,9,13,81,22,1,0
34,3/12/2020,30,74,0,0,0,0,0,0,0,1,0,0,6,17,104,23,0,0
34,3/13/2020,50,97,0,0,0,0,0,0,0,1,0,0,20,23,147,43,0,0
34,3/14/2020,50,97,0,0,0,0,0,0,0,1,0,0,0,0,147,0,0,0
34,3/15/2020,98,120,0,0,0,0,0,0,0,2,0,0,48,23,218,71,1,0
34,3/16/2020,178,120,0,0,0,0,0,0,0,2,0,0,80,0,298,80,0,0
34,3/17/2020,267,163,0,0,0,0,0,0,0,3,0,0,89,43,430,132,1,0
34,3/18/2020,427,190,0,0,0,0,0,0,0,5,0,0,160,27,617,187,2,0
34,3/19/2020,742,210,0,0,0,0,0,0,0,9,0,0,315,20,952,335,4,0
34,3/20/2020,890,264,0,0,0,0,0,0,0,11,0,0,148,54,1154,202,2,0
34,3/21/2020,1327,294,0,0,0,0,0,0,0,16,0,0,437,30,1621,467,5,0
34,3/22/2020,1914,327,0,0,0,0,0,0,0,20,0,0,587,33,2241,620,4,0
34,3/23/2020,2844,359,0,0,0,0,0,0,0,27,0,0,930,32,3203,962,7,0
34,3/24/2020,3675,8325,0,0,0,0,0,0,0,44,0,0,831,7966,12000,8797,17,0
34,3/25/2020,4402,10452,0,0,0,0,0,0,0,62,0,0,727,2127,14854,2854,18,0
34,3/26/2020,6876,13661,1080,0,0,0,0,0,0,81,0,0,2474,3209,20537,5683,19,0
34,3/27/2020,8825,16547,2000,0,0,0,0,0,0,108,0,0,1949,2886,25372,4835,27,0
34,3/28/2020,11124,19386,2000,0,0,0,0,0,0,140,0,0,2299,2839,30510,5138,32,0
34,3/29/2020,13386,22216,2000,0,0,0,0,0,0,161,0,0,2262,2830,35602,5092,21,0
34,3/30/2020,16636,25224,2000,0,0,0,0,0,0,198,0,0,3250,3008,41860,6258,37,0
34,3/31/2020,18696,27077,2000,0,0,0,0,0,0,267,0,0,2060,1853,45773,3913,69,0
34,4/1/2020,22255,30387,2000,0,0,0,0,0,0,355,0,0,3559,3310,52642,6869,88,0
34,4/2/2020,25590,33520,2000,0,0,0,0,0,0,537,0,0,3335,3133,59110,6468,182,0
34,4/3/2020,29895,37608,3016,0,0,0,0,0,0,646,0,0,4305,4088,67503,8393,109,0
34,4/4/2020,34124,41232,4000,0,0,0,0,0,0,846,0,0,4229,3624,75356,7853,200,0
34,4/5/2020,37505,44661,4000,0,0,0,0,0,0,917,0,0,3381,3429,82166,6810,71,0
34,4/6/2020,41090,47942,6390,0,0,0,1263,0,0,1003,0,0,3585,3281,89032,6866,86,0
34,4/7/2020,44416,50558,7017,0,1651,0,1540,0,0,1232,0,0,3326,2616,94974,5942,229,0
34,4/8/2020,47437,52979,7026,0,1617,0,1576,0,0,1504,0,0,3021,2421,100416,5442,272,0
34,4/9/2020,51027,56165,7363,0,1523,0,1551,0,0,1700,0,0,3590,3186,107192,6776,196,0
34,4/10/2020,54588,58935,7570,0,1679,0,1663,0,682,1932,0,0,3561,2770,113523,6331,232,0
34,4/11/2020,58151,62042,7618,0,1746,0,1650,0,0,2183,0,0,3563,3107,120193,6670,251,0
34,4/12/2020,61850,64885,7604,0,1914,0,1644,0,0,2350,0,0,3699,2843,126735,6542,167,0
34,4/13/2020,64584,64885,7781,0,1886,0,1611,0,0,2443,0,0,2734,0,129469,2734,93,0
34,4/14/2020,68824,70950,8185,0,2051,0,1626,0,0,2805,0,0,4240,6065,139774,10305,362,0
34,4/15/2020,71030,72991,8270,0,1980,0,1705,0,0,3156,0,0,2206,2041,144021,4247,351,0
34,4/16/2020,75317,76513,8224,0,2014,0,1645,0,0,3518,0,0,4287,3522,151830,7809,362,0
34,4/17/2020,78467,78982,8011,0,1961,0,1594,0,0,3840,0,0,3150,2469,157449,5619,322,0
34,4/18/2020,81420,81116,7718,0,2024,0,1641,0,0,4070,0,0,2953,2134,162536,5087,230,0
34,4/19/2020,85301,85387,7494,0,1940,0,1628,0,0,4202,0,0,3881,4271,170688,8152,132,0
34,4/20/2020,88806,89251,6986,0,2018,0,1594,0,0,4377,0,0,3505,3864,178057,7369,175,0
34,4/21/2020,92387,92439,7594,0,1930,0,1501,0,0,4753,0,0,3581,3188,184826,6769,376,0
34,4/22/2020,95865,95794,7210,0,1983,0,1570,0,0,5063,0,0,3478,3355,191659,6833,310,0
34,4/23/2020,99989,100159,7240,0,1990,0,1462,0,0,5368,0,0,4124,4365,200148,8489,305,0
34,4/24/2020,102196,103766,6847,0,1933,0,1487,0,0,5617,0,0,2207,3607,205962,5814,249,0
34,4/25/2020,105523,108163,6722,0,1971,0,1442,0,0,5863,0,0,3327,4397,213686,7724,246,0
34,4/26/2020,109038,114106,6573,0,1804,0,1418,0,0,5938,0,0,3515,5943,223144,9458,75,0
34,4/27/2020,111188,116587,6407,0,1801,0,1303,0,0,6044,0,0,2150,2481,227775,4631,106,0
34,4/28/2020,113856,120503,6476,0,1809,0,1262,0,15642,6442,0,0,2668,3916,234359,6584,398,0
34,4/29/2020,116264,125054,6289,0,1811,0,1327,0,15642,6770,0,0,2408,4551,241318,6959,328,0
34,4/30/2020,118652,129266,6137,0,1765,0,1271,0,15642,7228,0,0,2388,4212,247918,6600,458,0
34,5/1/2020,121190,135355,5972,0,1724,0,1286,0,15642,7538,0,0,2538,6089,256545,8627,310,0
34,5/2/2020,123717,138595,5713,0,1715,0,1230,0,15642,7742,0,0,2527,3240,262312,5767,204,0
34,5/3/2020,126744,148322,5317,0,1623,0,1198,0,15642,7871,0,0,3027,9727,275066,12754,129,0
34,5/4/2020,128269,148951,5287,0,1610,0,1189,0,15642,7910,0,0,1525,629,277220,2154,39,0
34,5/5/2020,130593,157030,5328,0,1534,0,1169,0,15642,8244,0,0,2324,8079,287623,10403,334,0
34,5/6/2020,131890,157030,5221,0,1549,0,1146,0,15642,8549,0,0,1297,0,288920,1297,305,0
34,5/7/2020,133635,159023,4996,0,1470,0,1107,0,15642,8801,0,0,1745,1993,292658,3738,252,0
34,5/8/2020,135454,163305,4605,0,1439,0,1089,0,15642,8952,0,0,1819,4282,298759,6101,151,0
34,5/9/2020,137085,168121,4628,0,1416,0,1054,0,15642,9116,0,0,1631,4816,305206,6447,164,0
34,5/10/2020,138532,173915,4308,0,1338,0,994,0,15642,9255,0,0,1447,5794,312447,7241,139,0
34,5/11/2020,139945,285988,4195,0,1255,0,970,0,15642,9310,0,0,1413,112073,425933,113486,55,0
34,5/12/2020,140743,292317,4328,0,1306,0,982,0,15642,9508,9508,0,798,6329,433060,7127,198,0
34,5/13/2020,141560,299890,4226,0,1226,0,928,0,15642,9702,9702,0,817,7573,441450,8390,194,0
34,5/14/2020,142704,308992,3958,0,1157,0,898,0,15642,9946,9946,0,1144,9102,451696,10246,244,0
34,5/15/2020,143905,319067,3823,0,1127,0,865,0,15642,10138,10138,0,1201,10075,462972,11276,192,0
34,5/16/2020,145089,330135,3564,0,1061,0,846,0,22939,10249,10249,0,1184,11068,475224,12252,111,0
34,5/17/2020,146334,341231,3411,0,1030,0,819,0,23299,10356,10356,0,1245,11096,487565,12341,107,0
34,5/18/2020,148039,357530,3509,0,1053,0,819,0,23496,10435,10435,0,1705,16299,505569,18004,79,0
34,5/19/2020,149013,371169,3481,0,977,0,789,0,23657,10586,10586,0,974,13639,520182,14613,151,0
34,5/20/2020,150399,380944,3405,0,969,0,750,0,23945,10747,10747,0,1386,9775,531343,11161,161,0
34,5/21/2020,151472,392802,3208,0,896,0,700,0,24236,10843,10843,0,1073,11858,544274,12931,96,0
34,5/22/2020,152719,402595,3049,0,846,0,674,0,24491,10985,10985,0,1247,9793,555314,11040,142,0
34,5/23/2020,153104,425631,2974,0,806,0,611,0,24762,11081,11081,0,385,23036,578735,23421,96,0
34,5/24/2020,154154,449653,2857,0,760,0,639,0,25040,11133,11133,0,1050,24022,603807,25072,52,0
34,5/25/2020,155092,468705,2755,0,719,0,540,0,25253,11144,11144,0,938,19052,623797,19990,11,0
34,5/26/2020,155764,480128,2723,16373,786,0,578,0,25384,11191,11191,0,672,11423,635892,12095,47,16373
34,5/27/2020,156628,503697,2761,16597,768,0,583,0,25552,11339,11339,0,864,23569,660325,24433,148,224
34,5/28/2020,157815,528042,2797,16778,740,0,564,0,25804,11401,11401,0,1187,24345,685857,25532,62,181
34,5/29/2020,158844,557567,2707,16960,720,0,544,0,26084,11531,11531,0,1029,29525,716411,30554,130,182
34,5/30/2020,159608,585700,2626,17121,672,0,499,0,26301,11634,11634,0,764,28133,745308,28897,103,161
34,5/31/2020,160445,585700,2497,17197,522,0,378,0,26560,11698,11698,0,837,0,746145,837,64,76
34,6/1/2020,160918,634682,2466,17222,646,0,459,0,26703,11721,11721,0,473,48982,795600,49455,23,25
34,6/2/2020,161545,656132,2370,17390,639,0,480,0,26815,11770,11770,0,627,21450,817677,22077,49,168
34,6/3/2020,162068,675352,2250,17390,612,0,459,0,27008,11880,11880,0,523,19220,837420,19743,110,0
34,6/4/2020,162530,695199,1982,17604,537,0,459,0,27231,11970,11970,0,462,19847,857729,20309,90,214
34,6/5/2020,163336,755555,1933,17880,542,0,410,0,27433,12049,12049,0,806,60356,918891,61162,79,276
34,6/6/2020,163893,755555,1933,18023,539,0,410,0,27641,12106,12106,0,557,0,919448,557,57,143
34,6/7/2020,164164,796261,1882,18050,503,0,385,0,27824,12176,12176,0,271,40706,960425,40977,70,27
34,6/8/2020,164497,810592,1740,18050,498,0,361,0,27941,12214,12214,0,333,14331,975089,14664,38,0
34,6/9/2020,164796,824701,1736,18069,510,0,373,0,28036,12303,12303,0,299,14109,989497,14408,89,19
34,6/10/2020,165346,843588,1701,18223,471,0,342,0,28207,12377,12377,0,550,18887,1008934,19437,74,154
34,6/11/2020,165816,864977,1512,18492,445,0,319,0,28376,12443,12443,0,470,21389,1030793,21859,66,269
34,6/12/2020,166164,889232,1480,18607,415,0,300,0,28509,12489,12489,0,348,24255,1055396,24603,46,115
34,6/13/2020,166605,911610,1395,18707,409,0,279,0,28606,12589,12589,0,441,22378,1078215,22819,100,100
34,6/14/2020,166881,930735,1391,18737,386,0,285,0,28714,12625,12625,0,276,19125,1097616,19401,36,30
34,6/15/2020,167103,948980,1342,18755,399,0,267,0,28819,12676,12676,0,222,18245,1116083,18467,51,18
34,6/16/2020,167426,964356,1291,18879,362,0,245,0,28872,12727,12727,0,323,15376,1131782,15699,51,124
34,6/17/2020,167703,980138,1352,19010,358,0,254,0,28966,12769,12769,0,277,15782,1147841,16059,42,131
34,6/18/2020,168107,1003627,1258,19010,319,0,257,0,29101,12800,12800,0,404,23489,1171734,23893,31,0
34,6/19/2020,168496,1025847,1177,19267,286,0,231,0,29209,12835,12835,0,389,22220,1194343,22609,35,257
34,6/20/2020,168834,1050039,1125,19267,286,0,238,0,29318,12857,12857,0,338,24192,1218873,24530,22,0
34,6/21/2020,169142,1075825,1105,19267,278,0,219,0,29450,12870,12870,0,308,25786,1244967,26094,13,0
34,6/22/2020,169415,1097984,1033,19401,287,0,213,0,29522,12895,12895,0,273,22159,1267399,22432,25,134
34,6/23/2020,169734,1113717,1092,19512,307,0,216,0,29517,12949,12949,0,319,15733,1283451,16052,54,111
34,6/24/2020,169892,1129753,1196,19598,275,0,214,0,29627,12995,12995,0,158,16036,1299645,16194,46,86
34,6/25/2020,170196,1150714,1182,19668,252,0,210,0,29740,14872,13018,1854,304,20961,1320910,21265,1877,70
34,6/26/2020,170584,1176088,1118,19752,234,0,206,0,29855,14914,13060,1854,388,25374,1346672,25762,42,84
34,6/27/2020,170873,1196377,1103,19823,236,0,200,0,29967,14948,13094,1854,289,20289,1367250,20578,34,71
34,6/28/2020,171182,1216651,1014,19841,223,0,187,0,30092,14975,13121,1854,309,20274,1387833,20583,27,18
34,6/29/2020,171272,1232712,978,19847,225,0,185,0,30163,14992,13138,1854,90,16061,1403984,16151,17,6
34,6/30/2020,171667,1250707,992,19847,211,0,174,0,30213,15035,13181,1854,395,17995,1422374,18390,43,0
34,7/1/2020,171928,1271009,1080,20054,217,0,178,0,30300,15078,13224,1854,261,20302,1442937,20563,43,207
34,7/2/2020,172356,1291557,1027,20141,216,0,170,0,30383,15107,13251,1856,428,20548,1463913,20976,29,87
34,7/3/2020,172742,1312759,1028,20214,216,0,167,0,30464,15164,13308,1856,386,21202,1485501,21588,57,73
34,7/4/2020,173033,1335515,983,20233,205,0,164,0,30565,15189,13333,1856,291,22756,1508548,23047,25,19
34,7/5/2020,173402,1361238,917,20237,210,0,151,0,30660,15211,13355,1856,369,25723,1534640,26092,22,4
34,7/6/2020,173611,1375598,861,20237,187,0,152,0,30729,15229,13373,1856,209,14360,1549209,14569,18,0
34,7/7/2020,173878,1386255,903,20246,169,0,142,0,30774,15281,13425,1856,267,10657,1560133,10924,52,9
34,7/8/2020,174039,1403809,935,20426,175,0,142,0,30844,15423,13476,1947,161,17554,1577848,17715,142,180
34,7/9/2020,174240,1425177,963,20505,170,0,104,0,30938,15448,13501,1947,201,21368,1599417,21569,25,79
34,7/10/2020,174628,1448530,904,20567,162,0,94,0,31014,15479,13532,1947,388,23353,1623158,23741,31,62
34,7/11/2020,174959,1486325,872,20632,166,0,87,0,31092,15525,13578,1947,331,37795,1661284,38126,46,65
34,7/12/2020,175298,1510306,890,20632,163,0,86,0,31190,15541,13594,1947,339,23981,1685604,24320,16,0
34,7/13/2020,175522,1524863,892,20632,166,0,81,0,31261,15560,13613,1947,224,14557,1700385,14781,19,0
34,7/14/2020,175915,1545316,888,20632,149,0,79,0,31318,15582,13635,1947,393,20453,1721231,20846,22,0
34,7/15/2020,176278,1566069,923,20774,151,0,78,0,31400,15607,13660,1947,363,20753,1742347,21116,25,142
34,7/16/2020,176501,1583403,862,20774,146,0,64,0,31400,15665,13691,1974,223,17334,1759904,17557,58,0
34,7/17/2020,176551,1592377,868,21003,141,0,66,0,31400,15684,13710,1974,50,8974,1768928,9024,19,229
35,3/6/2020,0,16,0,0,0,0,0,0,0,0,0,0,0,0,16,0,0,0
35,3/7/2020,0,48,0,0,0,0,0,0,0,0,0,0,0,32,48,32,0,0
35,3/8/2020,0,48,0,0,0,0,0,0,0,0,0,0,0,0,48,0,0,0
35,3/9/2020,0,57,0,0,0,0,0,0,0,0,0,0,0,9,57,9,0,0
35,3/10/2020,0,69,0,0,0,0,0,0,0,0,0,0,0,12,69,12,0,0
35,3/11/2020,3,87,0,0,0,0,0,0,0,0,0,0,3,18,90,21,0,0
35,3/12/2020,5,155,0,0,0,0,0,0,0,0,0,0,2,68,160,70,0,0
35,3/13/2020,10,190,0,0,0,0,0,0,0,0,0,0,5,35,200,40,0,0
35,3/14/2020,10,237,0,0,0,0,0,0,0,0,0,0,0,47,247,47,0,0
35,3/15/2020,13,482,0,0,0,0,0,0,0,0,0,0,3,245,495,248,0,0
35,3/16/2020,17,566,0,0,0,0,0,0,0,0,0,0,4,84,583,88,0,0
35,3/17/2020,23,1249,0,0,0,0,0,0,0,0,0,0,6,683,1272,689,0,0
35,3/18/2020,28,2326,0,0,0,0,0,0,0,0,0,0,5,1077,2354,1082,0,0
35,3/19/2020,35,2762,0,0,0,0,0,0,0,0,0,0,7,436,2797,443,0,0
35,3/20/2020,43,3771,0,0,0,0,0,0,0,0,0,0,8,1009,3814,1017,0,0
35,3/21/2020,57,3771,0,0,0,0,0,0,0,0,0,0,14,0,3828,14,0,0
35,3/22/2020,57,4722,0,0,0,0,0,0,0,0,0,0,0,951,4779,951,0,0
35,3/23/2020,65,5321,0,0,0,0,0,0,0,0,0,0,8,599,5386,607,0,0
35,3/24/2020,83,5890,0,0,0,0,0,0,0,0,0,0,18,569,5973,587,0,0
35,3/25/2020,100,6742,0,0,0,0,0,0,0,1,0,0,17,852,6842,869,1,0
35,3/26/2020,112,7681,0,0,0,0,0,0,0,1,0,0,12,939,7793,951,0,0
35,3/27/2020,136,8377,0,0,0,0,0,0,0,1,0,0,24,696,8513,720,0,0
35,3/28/2020,191,9196,17,0,0,0,0,0,0,1,0,0,55,819,9387,874,0,0
35,3/29/2020,237,10769,19,0,0,0,0,0,2,2,0,0,46,1573,11006,1619,1,0
35,3/30/2020,237,10942,22,0,0,0,0,0,26,2,0,0,0,173,11179,173,0,0
35,3/31/2020,281,12246,22,0,0,0,0,0,26,4,0,0,44,1304,12527,1348,2,0
35,4/1/2020,315,12925,24,0,0,0,0,0,26,5,0,0,34,679,13240,713,1,0
35,4/2/2020,363,13648,31,0,0,0,0,0,26,6,0,0,48,723,14011,771,1,0
35,4/3/2020,403,14375,31,0,0,0,0,0,26,7,0,0,40,727,14778,767,1,0
35,4/4/2020,495,15137,41,0,0,0,18,0,26,10,0,0,92,762,15632,854,3,0
35,4/5/2020,543,16285,37,0,0,0,18,0,54,11,0,0,48,1148,16828,1196,1,0
35,4/6/2020,624,18512,45,0,0,0,18,0,130,12,0,0,81,2227,19136,2308,1,0
35,4/7/2020,686,21139,48,0,0,0,18,0,133,12,0,0,62,2627,21825,2689,0,0
35,4/8/2020,794,21451,51,0,0,0,18,0,171,13,0,0,108,312,22245,420,1,0
35,4/9/2020,865,22942,59,0,0,0,18,0,201,16,0,0,71,1491,23807,1562,3,0
35,4/10/2020,1091,26007,73,0,0,0,18,0,217,19,0,0,226,3065,27098,3291,3,0
35,4/11/2020,1091,26007,75,0,0,0,18,0,235,19,0,0,0,0,27098,0,0,0
35,4/12/2020,1174,27518,78,0,0,0,18,0,235,20,0,0,83,1511,28692,1594,1,0
35,4/13/2020,1245,29270,80,0,0,0,0,0,295,26,0,0,71,1752,30515,1823,6,0
35,4/14/2020,1345,30625,87,181,0,0,0,0,304,31,0,0,100,1355,31970,1455,5,181
35,4/15/2020,1407,31443,87,181,0,0,0,0,340,36,0,0,62,818,32850,880,5,0
35,4/16/2020,1484,31910,90,215,0,0,0,0,353,36,0,0,77,467,33394,544,0,34
35,4/17/2020,1597,32891,90,230,0,0,0,0,353,44,0,0,113,981,34488,1094,8,15
35,4/18/2020,1711,33902,96,242,0,0,0,0,382,51,0,0,114,1011,35613,1125,7,12
35,4/19/2020,1798,34834,92,258,0,0,0,0,465,53,0,0,87,932,36632,1019,2,16
35,4/20/2020,1845,35197,103,274,0,0,0,0,487,55,0,0,47,363,37042,410,2,16
35,4/21/2020,1971,36784,116,291,0,0,0,0,501,58,0,0,126,1587,38755,1713,3,17
35,4/22/2020,2072,38805,119,306,0,0,0,0,529,65,0,0,101,2021,40877,2122,7,15
35,4/23/2020,2210,39022,121,331,0,0,0,0,547,71,0,0,138,217,41232,355,6,25
35,4/24/2020,2379,44184,123,367,0,0,0,0,573,78,0,0,169,5162,46563,5331,7,36
35,4/25/2020,2521,48989,152,412,0,0,0,0,614,84,0,0,142,4805,51510,4947,6,45
35,4/26/2020,2660,51075,152,412,0,0,0,0,614,93,0,0,139,2086,53735,2225,9,0
35,4/27/2020,2726,53889,148,412,0,0,0,0,650,99,0,0,66,2814,56615,2880,6,0
35,4/28/2020,2823,55980,155,481,0,0,0,0,666,104,0,0,97,2091,58803,2188,5,69
35,4/29/2020,2974,58771,157,509,0,0,0,0,705,110,0,0,151,2791,61745,2942,6,28
35,4/30/2020,3213,61872,163,536,0,0,0,0,734,112,0,0,239,3101,65085,3340,2,27
35,5/1/2020,3411,64458,172,536,0,0,0,0,760,123,0,0,198,2586,67869,2784,11,0
35,5/2/2020,3513,67605,159,587,0,0,0,0,785,131,0,0,102,3147,71118,3249,8,51
35,5/3/2020,3732,71212,168,587,0,0,0,0,812,139,0,0,219,3607,74944,3826,8,0
35,5/4/2020,3850,74127,164,587,0,0,0,0,832,151,0,0,118,2915,77977,3033,12,0
35,5/5/2020,4031,77689,181,667,0,0,0,0,842,156,0,0,181,3562,81720,3743,5,80
35,5/6/2020,4138,79113,178,687,0,0,0,0,964,162,0,0,107,1424,83251,1531,6,20
35,5/7/2020,4291,81393,193,687,0,0,0,0,1073,169,0,0,153,2280,85684,2433,7,0
35,5/8/2020,4493,84539,197,760,0,0,0,0,1125,172,0,0,202,3146,89032,3348,3,73
35,5/9/2020,4673,88589,201,789,0,0,0,0,1189,181,0,0,180,4050,93262,4230,9,29
35,5/10/2020,4778,92275,198,789,0,0,0,0,1268,191,0,0,105,3686,97053,3791,10,0
35,5/11/2020,4863,97635,194,789,0,0,0,0,1285,200,0,0,85,5360,102498,5445,9,0
35,5/12/2020,5069,101652,207,886,0,0,0,0,1300,208,0,0,206,4017,106721,4223,8,97
35,5/13/2020,5212,105077,199,886,0,0,0,0,1434,219,0,0,143,3425,110289,3568,11,0
35,5/14/2020,5364,109647,200,886,0,0,0,0,1515,231,0,0,152,4570,115011,4722,12,0
35,5/15/2020,5503,114098,209,886,0,0,0,0,1576,242,0,0,139,4451,119601,4590,11,0
35,5/16/2020,5662,118796,223,886,0,0,0,0,1671,253,0,0,159,4698,124458,4857,11,0
35,5/17/2020,5857,122727,208,886,0,0,0,0,1739,259,0,0,195,3931,128584,4126,6,0
35,5/18/2020,5938,127315,211,886,0,0,0,0,1755,265,0,0,81,4588,133253,4669,6,0
35,5/19/2020,6096,131524,213,886,0,0,0,0,1796,270,0,0,158,4209,137620,4367,5,0
35,5/20/2020,6192,136054,204,1139,0,0,0,0,1882,276,0,0,96,4530,142246,4626,6,253
35,5/21/2020,6317,141027,206,1139,0,0,0,0,1985,283,0,0,125,4973,147344,5098,7,0
35,5/22/2020,6472,146295,205,1139,0,0,0,0,2041,294,0,0,155,5268,152767,5423,11,0
35,5/23/2020,6625,151758,206,1139,0,0,0,0,2149,302,0,0,153,5463,158383,5616,8,0
35,5/24/2020,6795,162324,208,1139,0,0,0,0,2357,308,0,0,170,10566,169119,10736,6,0
35,5/25/2020,6943,166538,213,1243,0,0,0,0,2464,317,0,0,148,4214,173481,4362,9,104
35,5/26/2020,7026,170335,216,1264,0,0,0,0,2522,320,0,0,83,3797,177361,3880,3,21
35,5/27/2020,7130,173516,211,1282,0,0,0,0,2564,325,0,0,104,3181,180646,3285,5,18
35,5/28/2020,7252,172291,210,1282,0,0,0,0,2638,329,0,0,122,-1225,179543,-1103,4,0
35,5/29/2020,7364,176180,196,1317,0,0,0,0,2684,335,0,0,112,3889,183544,4001,6,35
35,5/30/2020,7493,180768,193,1317,0,0,0,0,2728,344,0,0,129,4588,188261,4717,9,0
35,5/31/2020,7624,186823,189,1317,0,0,0,0,2835,351,0,0,131,6055,194447,6186,7,0
35,6/1/2020,7689,191915,182,1317,0,0,0,0,2853,356,0,0,65,5092,199604,5157,5,0
35,6/2/2020,7800,195315,191,1317,0,0,0,0,2888,362,0,0,111,3400,203115,3511,6,0
35,6/3/2020,8024,198813,182,1416,0,0,0,0,2960,367,0,0,224,3498,206837,3722,5,99
35,6/4/2020,8140,204856,170,1416,0,0,0,0,3013,375,0,0,116,6043,212996,6159,8,0
35,6/5/2020,8353,209404,170,1416,0,0,0,0,3115,383,0,0,213,4548,217757,4761,8,0
35,6/6/2020,8672,215968,175,1489,0,0,0,0,3206,387,0,0,319,6564,224640,6883,4,73
35,6/7/2020,8800,220347,176,1489,0,0,0,0,3286,392,0,0,128,4379,229147,4507,5,0
35,6/8/2020,8940,225435,177,1533,0,0,0,0,3307,396,0,0,140,5088,234375,5228,4,44
35,6/9/2020,9062,229739,183,1558,0,0,0,0,3380,400,0,0,122,4304,238801,4426,4,25
35,6/10/2020,9105,232552,193,1583,0,0,0,0,3699,404,0,0,43,2813,241657,2856,4,25
35,6/11/2020,9250,236307,197,1583,0,0,0,0,3806,410,0,0,145,3755,245557,3900,6,0
35,6/12/2020,9526,245758,179,1625,0,0,0,0,3983,426,0,0,276,9451,255284,9727,16,42
35,6/13/2020,9526,245758,179,1625,0,0,0,0,3983,426,0,0,0,0,255284,0,0,0
35,6/14/2020,9621,249373,172,1625,0,0,0,0,4072,431,0,0,95,3615,258994,3710,5,0
35,6/15/2020,9723,253942,162,1625,0,0,0,0,4114,435,0,0,102,4569,263665,4671,4,0
35,6/16/2020,9845,258076,161,1686,0,0,0,0,4160,440,0,0,122,4134,267921,4256,5,61
35,6/17/2020,9933,261620,156,1698,0,0,0,0,4217,447,0,0,88,3544,271553,3632,7,12
35,6/18/2020,10065,265832,161,1715,0,0,0,0,4351,452,0,0,132,4212,275897,4344,5,17
35,6/19/2020,10153,270022,157,1726,0,0,0,0,4439,456,0,0,88,4190,280175,4278,4,11
35,6/20/2020,10260,274342,147,1735,0,0,0,0,4512,464,0,0,107,4320,284602,4427,8,9
35,6/21/2020,10565,282866,134,1746,0,0,0,0,4684,469,0,0,305,8524,293431,8829,5,11
35,6/22/2020,10565,282866,134,1746,0,0,0,0,4684,469,0,0,0,0,293431,0,0,0
35,6/23/2020,10694,287382,139,1754,0,0,0,0,4742,469,0,0,129,4516,298076,4645,0,8
35,6/24/2020,10838,291245,141,1776,0,0,0,0,4874,476,0,0,144,3863,302083,4007,7,22
35,6/25/2020,10990,297115,149,1793,0,0,0,0,4984,480,0,0,152,5870,308105,6022,4,17
35,6/26/2020,11192,303478,135,1811,0,0,0,0,5047,485,0,0,202,6363,314670,6565,5,18
35,6/27/2020,11408,309230,128,1828,0,0,0,0,5149,489,0,0,216,5752,320638,5968,4,17
35,6/28/2020,11619,311340,122,1851,0,0,0,0,5251,491,0,0,211,2110,322959,2321,2,23
35,6/29/2020,11809,319239,114,1865,0,0,0,0,5264,492,0,0,190,7899,331048,8089,1,14
35,6/30/2020,11982,325738,119,1876,0,0,0,0,5296,493,0,0,173,6499,337720,6672,1,11
35,7/1/2020,12147,332034,127,1902,0,0,0,0,5393,497,0,0,165,6296,344181,6461,4,26
35,7/2/2020,12276,337784,127,1928,0,0,0,0,5514,500,0,0,129,5750,350060,5879,3,26
35,7/3/2020,12520,344117,127,1945,0,0,0,0,5627,503,0,0,244,6333,356637,6577,3,17
35,7/4/2020,12776,350598,130,1970,0,0,0,0,5802,511,0,0,256,6481,363374,6737,8,25
35,7/5/2020,13063,359225,121,1988,0,0,0,0,5845,513,0,0,287,8627,372288,8914,2,18
35,7/6/2020,13256,361798,119,2006,0,0,0,0,5860,513,0,0,193,2573,375054,2766,0,18
35,7/7/2020,13507,366733,129,2033,0,0,0,0,5902,515,0,0,251,4935,380240,5186,2,27
35,7/8/2020,13727,371515,133,2056,0,0,0,0,5986,519,0,0,220,4782,385242,5002,4,23
35,7/9/2020,14017,375670,154,2101,0,0,0,0,6051,527,0,0,290,4155,389687,4445,8,45
35,7/10/2020,14251,381630,154,2137,0,0,0,0,6118,533,0,0,234,5960,395881,6194,6,36
35,7/11/2020,14549,389032,151,2161,0,0,0,0,6181,539,0,0,298,7402,403581,7700,6,24
35,7/12/2020,14773,395981,158,2187,0,0,0,0,6271,543,0,0,224,6949,410754,7173,4,26
35,7/13/2020,15028,403329,170,2204,0,0,0,0,6322,545,0,0,255,7348,418357,7603,2,17
35,7/14/2020,15291,409064,172,2227,0,0,0,0,6363,548,0,0,263,5735,424355,5998,3,23
35,7/15/2020,15514,414492,171,2261,0,0,0,0,6429,551,0,0,223,5428,430006,5651,3,34
35,7/16/2020,15841,421164,174,2284,0,0,0,0,6496,557,0,0,327,6672,437005,6999,6,23
35,7/17/2020,16138,427230,170,2312,0,0,0,0,6578,562,0,0,297,6066,443368,6363,5,28
36,3/4/2020,6,48,0,0,0,0,0,0,0,0,0,0,0,0,54,0,0,0
36,3/5/2020,22,76,0,0,0,0,0,0,0,0,0,0,16,28,98,44,0,0
36,3/6/2020,33,92,0,0,0,0,0,0,0,0,0,0,11,16,125,27,0,0
36,3/7/2020,76,92,0,0,0,0,0,0,0,0,0,0,43,0,168,43,0,0
36,3/8/2020,105,92,0,0,0,0,0,0,0,0,0,0,29,0,197,29,0,0
36,3/9/2020,142,92,0,0,0,0,0,0,0,0,0,0,37,0,234,37,0,0
36,3/10/2020,173,92,0,0,0,0,0,0,0,0,0,0,31,0,265,31,0,0
36,3/11/2020,216,92,0,0,0,0,0,0,0,0,0,0,43,0,308,43,0,0
36,3/12/2020,216,92,0,0,0,0,0,0,0,0,0,0,0,0,308,0,0,0
36,3/13/2020,421,2779,0,0,0,0,0,0,0,0,0,0,205,2687,3200,2892,0,0
36,3/14/2020,524,2779,0,0,0,0,0,0,0,0,0,0,103,0,3303,103,0,0
36,3/15/2020,729,4543,0,0,0,0,0,0,0,3,0,0,205,1764,5272,1969,3,0
36,3/16/2020,950,4543,0,0,0,0,0,0,0,7,0,0,221,0,5493,221,4,0
36,3/17/2020,1700,5506,325,0,0,0,0,0,0,7,0,0,750,963,7206,1713,0,0
36,3/18/2020,2382,12215,416,0,0,0,0,0,0,12,0,0,682,6709,14597,7391,5,0
36,3/19/2020,4152,18132,617,0,0,0,0,0,0,12,0,0,1770,5917,22284,7687,0,0
36,3/20/2020,7102,25325,1042,0,0,0,0,0,0,35,0,0,2950,7193,32427,10143,23,0
36,3/21/2020,10356,35081,1436,1531,0,0,0,0,0,44,0,0,3254,9756,45437,13010,9,1531
36,3/22/2020,15168,46233,2043,2354,0,0,0,0,0,114,0,0,4812,11152,61401,15964,70,823
36,3/23/2020,20875,57414,2629,3125,0,0,0,0,0,114,0,0,5707,11181,78289,16888,0,771
36,3/24/2020,25665,65605,3343,4041,0,0,0,0,0,210,0,0,4790,8191,91270,12981,96,916
36,3/25/2020,30811,72668,4079,5126,0,0,0,0,0,285,0,0,5146,7063,103479,12209,75,1085
36,3/26/2020,37258,84846,5327,6921,1290,0,0,0,0,385,0,0,6447,12178,122104,18625,100,1795
36,3/27/2020,44635,101118,6481,8732,1583,0,0,0,2045,519,0,0,7377,16272,145753,23649,134,1811
36,3/28/2020,52318,103616,7328,10454,1755,0,0,0,2726,728,0,0,7683,2498,155934,10181,209,1722
36,3/29/2020,59513,112847,8503,12695,2037,0,0,0,3572,965,0,0,7195,9231,172360,16426,237,2241
36,3/30/2020,66497,119971,9517,14578,2352,0,0,0,4204,1218,0,0,6984,7124,186468,14108,253,1883
36,3/31/2020,75795,129391,10929,17085,2710,0,0,0,4975,1550,0,0,9298,9420,205186,18718,332,2507
36,4/1/2020,83712,137168,12226,19929,3022,0,0,0,6142,1941,0,0,7917,7777,220880,15694,391,2844
36,4/2/2020,92381,146584,13383,22786,3396,0,0,0,7434,2373,0,0,8669,9416,238965,18085,432,2857
36,4/3/2020,102863,157657,14810,26210,3731,0,0,0,8886,2935,0,0,10482,11073,260520,21555,562,3424
36,4/4/2020,113704,169917,15905,29471,4126,0,0,0,10478,3565,0,0,10841,12260,283621,23101,630,3261
36,4/5/2020,122031,180249,16479,32293,4376,0,0,0,12187,4159,0,0,8327,10332,302280,18659,594,2822
36,4/6/2020,130689,190122,16837,34377,4504,0,0,0,13366,4758,0,0,8658,9873,320811,18531,599,2084
36,4/7/2020,138863,201195,17493,36932,4539,0,0,0,14590,5489,0,0,8174,11073,340058,19247,731,2555
36,4/8/2020,149316,215837,18079,39982,4841,0,0,0,16353,6268,0,0,10453,14642,365153,25095,779,3050
36,4/9/2020,159937,231612,18279,42852,4925,0,0,0,18297,7067,0,0,10621,15775,391549,26396,799,2870
36,4/10/2020,170512,247373,18569,45768,4908,0,0,0,20249,7844,0,0,10575,15761,417885,26336,777,2916
36,4/11/2020,180458,260522,18654,48297,5009,0,0,0,22025,8627,0,0,9946,13149,440980,23095,783,2529
36,4/12/2020,188694,272907,18707,50919,5198,0,0,0,23887,9385,0,0,8236,12385,461601,20621,758,2622
36,4/13/2020,195031,283326,18825,52936,5156,0,0,0,23887,10056,0,0,6337,10419,478357,16756,671,2017
36,4/14/2020,202208,296935,18697,54653,5225,0,0,0,25589,10834,0,0,7177,13609,499143,20786,778,1717
36,4/15/2020,213779,312233,18335,56968,5205,0,0,0,28004,11586,0,0,11571,15298,526012,26869,752,2315
36,4/16/2020,222284,328295,17735,59052,5071,0,0,0,30800,12192,0,0,8505,16062,550579,24567,606,2084
36,4/17/2020,229642,343581,17316,61120,5039,0,0,0,33392,12822,0,0,7358,15286,573223,22644,630,2068
36,4/18/2020,236732,359800,16967,63103,4996,0,0,0,35458,13362,0,0,7090,16219,596532,23309,540,1983
36,4/19/2020,242786,374769,16213,64550,4878,0,0,0,37596,13869,0,0,6054,14969,617555,21023,507,1447
36,4/20/2020,247512,386349,16103,65969,4814,0,0,0,39085,14347,0,0,4726,11580,633861,16306,478,1419
36,4/21/2020,251690,397635,16135,67271,4729,0,0,0,40482,14828,0,0,4178,11286,649325,15464,481,1302
36,4/22/2020,257216,412766,15599,68773,4690,0,0,0,42308,15302,0,0,5526,15131,669982,20657,474,1502
36,4/23/2020,263460,432460,15021,70182,4597,0,0,0,44244,15740,0,0,6244,19694,695920,25938,438,1409
36,4/24/2020,271590,459066,14258,71373,4540,0,0,0,46156,16162,0,0,8130,26606,730656,34736,422,1191
36,4/25/2020,282143,495425,13524,72444,4410,0,0,0,47935,16599,0,0,10553,36359,777568,46912,437,1071
36,4/26/2020,288045,517305,12839,73540,4284,0,0,0,49687,16966,0,0,5902,21880,805350,27782,367,1096
36,4/27/2020,291996,534099,12819,74602,4157,0,0,0,50751,17303,0,0,3951,16794,826095,20745,337,1062
36,4/28/2020,295106,549888,12646,75362,4071,0,0,0,51673,17638,0,0,3110,15789,844994,18899,335,760
36,4/29/2020,299691,572790,12159,76450,3923,0,0,0,53238,18015,0,0,4585,22902,872481,27487,377,1088
36,4/30/2020,304372,596264,11598,77400,3769,0,0,0,54771,18321,0,0,4681,23474,900636,28155,306,950
36,5/1/2020,308314,619124,10993,78224,3640,0,0,0,56187,18610,0,0,3942,22860,927438,26802,289,824
36,5/2/2020,312977,646094,10350,78942,3501,0,0,0,57540,18909,0,0,4663,26970,959071,31633,299,718
36,5/3/2020,316415,669496,9786,79768,3430,0,0,0,58950,19189,0,0,3438,23402,985911,26840,280,826
36,5/4/2020,318953,688357,9647,80376,3330,0,0,0,58950,19415,0,0,2538,18861,1007310,21399,226,608
36,5/5/2020,321192,707707,9600,80918,3281,0,0,0,58950,19645,0,0,2239,19350,1028899,21589,230,542
36,5/6/2020,323978,731943,9179,81570,3098,0,0,0,54597,19877,0,0,2786,24236,1055921,27022,232,652
36,5/7/2020,327649,762267,8665,82197,2976,0,2425,0,55547,20828,0,0,3671,30324,1089916,33995,951,627
36,5/8/2020,330407,791136,8196,82730,2811,0,2295,0,56378,21045,0,0,2758,28869,1121543,31627,217,533
36,5/9/2020,333122,820646,7776,83285,2664,0,2203,0,57180,21271,0,0,2715,29510,1153768,32225,226,555
36,5/10/2020,335395,847603,7262,83761,2488,0,2073,0,58006,21478,0,0,2273,26957,1182998,29230,207,476
36,5/11/2020,337055,867596,7226,84194,2450,0,2020,0,58363,21640,0,0,1660,19993,1204651,21653,162,433
36,5/12/2020,338485,886628,7063,84489,2375,0,1964,0,58679,21845,0,0,1430,19032,1225113,20462,205,295
36,5/13/2020,340661,918246,6946,85008,2308,0,1908,0,59193,22013,0,0,2176,31618,1258907,33794,168,519
36,5/14/2020,343051,955706,6706,85454,2223,0,1846,0,59758,22170,0,0,2390,37460,1298757,39850,157,446
36,5/15/2020,345813,992235,6394,85782,2156,0,1774,0,60302,22304,0,0,2762,36529,1338048,39291,134,328
36,5/16/2020,348232,1030485,6220,86207,2077,0,1674,0,60796,22478,0,0,2419,38250,1378717,40669,174,425
36,5/17/2020,350121,1063275,5897,86575,1981,0,1601,0,61381,22619,0,0,1889,32790,1413396,34679,141,368
36,5/18/2020,351371,1088186,5840,86901,1908,0,1538,0,61681,22729,0,0,1250,24911,1439557,26161,110,326
36,5/19/2020,352845,1114894,5818,87169,1836,0,1481,0,61886,22843,0,0,1474,26708,1467739,28182,114,268
36,5/20/2020,354370,1151466,5570,87459,1761,0,1421,0,61886,22976,0,0,1525,36572,1505836,38097,133,290
36,5/21/2020,356458,1198597,5187,87638,1695,0,1345,0,62826,23083,0,0,2088,47131,1555055,49219,107,179
36,5/22/2020,358154,1242639,4844,87843,1581,0,1254,0,63292,23195,0,0,1696,44042,1600793,45738,112,205
36,5/23/2020,359926,1292135,4642,88083,1502,0,1254,0,63292,23282,0,0,1772,49496,1652061,51268,87,240
36,5/24/2020,361515,1338311,4393,88324,1406,0,1067,0,64080,23391,0,0,1589,46176,1699826,47765,109,241
36,5/25/2020,362764,1376685,4348,88554,1366,0,1058,0,64280,23488,0,0,1249,38374,1739449,39623,97,230
36,5/26/2020,363836,1410292,4265,88686,1273,0,1002,0,64443,23564,0,0,1072,33607,1774128,34679,76,132
36,5/27/2020,364965,1446579,4208,88866,1261,0,988,0,64632,23643,0,0,1129,36287,1811544,37416,79,180
36,5/28/2020,366733,1510056,4010,89042,1219,0,931,0,64954,23722,0,0,1768,63477,1876789,65245,79,176
36,5/29/2020,368284,1575846,3781,89194,1164,0,889,0,65289,23780,0,0,1551,65790,1944130,67341,58,152
36,5/30/2020,369660,1635721,3619,89400,1124,0,857,0,65609,23848,0,0,1376,59875,2005381,61251,68,206
36,5/31/2020,370770,1693055,3436,89590,1050,0,791,0,65934,23905,0,0,1110,57334,2063825,58444,57,190
36,6/1/2020,371711,1742066,3331,89703,999,0,746,0,66110,23959,0,0,941,49011,2113777,49952,54,113
36,6/2/2020,373040,1794791,3121,89861,907,0,673,0,66262,24023,0,0,1329,52725,2167831,54054,64,158
36,6/3/2020,374085,1855388,2978,89995,865,0,638,0,66502,24079,0,0,1045,60597,2229473,61642,56,134
36,6/4/2020,375133,1917899,2849,89995,832,0,613,0,66756,24133,0,0,1048,62511,2293032,63559,54,0
36,6/5/2020,376208,1983304,2728,89995,758,0,583,0,66992,24175,0,0,1075,65405,2359512,66480,42,0
36,6/6/2020,377316,2060091,2603,89995,720,0,554,0,67261,24212,0,0,1108,76787,2437407,77895,37,0
36,6/7/2020,378097,2119745,2427,89995,704,0,534,0,67544,24259,0,0,781,59654,2497842,60435,47,0
36,6/8/2020,378799,2177097,2371,89995,678,0,507,0,67687,24299,0,0,702,57352,2555896,58054,40,0
36,6/9/2020,379482,2226387,2344,89995,663,0,485,0,67808,24348,0,0,683,49290,2605869,49973,49,0
36,6/10/2020,380156,2288010,2190,89995,630,0,462,0,68019,24404,0,0,674,61623,2668166,62297,56,0
36,6/11/2020,380892,2348113,2042,89995,581,0,424,0,68211,24442,0,0,736,60103,2729005,60839,38,0
36,6/12/2020,381714,2419686,1898,89995,552,0,387,0,68399,24495,0,0,822,71573,2801400,72395,53,0
36,6/13/2020,382630,2489610,1734,89995,517,0,360,0,68584,24527,0,0,916,69924,2872240,70840,32,0
36,6/14/2020,383324,2551275,1657,89995,499,0,346,0,68761,24551,0,0,694,61665,2934599,62359,24,0
36,6/15/2020,383944,2607266,1608,89995,470,0,323,0,68851,24579,0,0,620,55991,2991210,56611,28,0
36,6/16/2020,384575,2667203,1538,89995,449,0,303,0,68938,24608,0,0,631,59937,3051778,60568,29,0
36,6/17/2020,385142,2725977,1479,89995,431,0,304,0,69085,24629,0,0,567,58774,3111119,59341,21,0
36,6/18/2020,385760,2793900,1358,89995,388,0,278,0,69243,24661,0,0,618,67923,3179660,68541,32,0
36,6/19/2020,386556,2872407,1284,89995,359,0,256,0,69377,24686,0,0,796,78507,3258963,79303,25,0
36,6/20/2020,387272,2940521,1220,89995,335,0,237,0,69506,24710,0,0,716,68114,3327793,68830,24,0
36,6/21/2020,387936,3007383,1142,89995,332,0,237,0,69506,24725,0,0,664,66862,3395319,67526,15,0
36,6/22/2020,388488,3063611,1122,89995,330,0,228,0,69710,24739,0,0,552,56228,3452099,56780,14,0
36,6/23/2020,389085,3111723,1104,89995,302,0,228,0,69710,24766,0,0,597,48112,3500808,48709,27,0
36,6/24/2020,389666,3162286,1071,89995,290,0,228,0,69710,24782,0,0,581,50563,3551952,51144,16,0
36,6/25/2020,390415,3229179,996,89995,270,0,167,0,70010,24800,0,0,749,66893,3619594,67642,18,0
36,6/26/2020,391220,3290097,951,89995,244,0,167,0,70010,24814,0,0,805,60918,3681317,61723,14,0
36,6/27/2020,391923,3362656,908,89995,230,0,167,0,70010,24830,0,0,703,72559,3754579,73262,16,0
36,6/28/2020,392539,3423946,869,89995,229,0,167,0,70010,24835,0,0,616,61290,3816485,61906,5,0
36,6/29/2020,392930,3469983,853,89995,216,0,136,0,70435,24842,0,0,391,46037,3862913,46428,7,0
36,6/30/2020,393454,3521484,891,89995,217,0,137,0,70487,24855,0,0,524,51501,3914938,52025,13,0
36,7/1/2020,394079,3577569,879,89995,226,0,139,0,70590,24866,0,0,625,56085,3971648,56710,11,0
36,7/2/2020,394954,3646639,878,89995,209,0,129,0,70698,24877,0,0,875,69070,4041593,69945,11,0
36,7/3/2020,395872,3712113,857,89995,188,0,125,0,70794,24885,0,0,918,65474,4107985,66392,8,0
36,7/4/2020,396598,3773790,844,89995,190,0,119,0,70877,24896,0,0,726,61677,4170388,62403,11,0
36,7/5/2020,397131,3836672,832,89995,178,0,116,0,70968,24904,0,0,533,62882,4233803,63415,8,0
36,7/6/2020,397649,3890482,817,89995,170,0,103,0,71040,24913,0,0,518,53810,4288131,54328,9,0
36,7/7/2020,398237,3946630,836,89995,160,0,103,0,71091,24924,0,0,588,56148,4344867,56736,11,0
36,7/8/2020,398929,4003523,841,89995,166,0,97,0,71185,24944,0,0,692,56893,4402452,57585,20,0
36,7/9/2020,399513,4068503,851,89995,173,0,98,0,71279,24959,0,0,584,64980,4468016,65564,15,0
36,7/10/2020,400299,4141275,826,89995,178,0,92,0,71371,24968,0,0,786,72772,4541574,73558,9,0
36,7/11/2020,401029,4209748,799,89995,177,0,100,0,71477,24974,0,0,730,68473,4610777,69203,6,0
36,7/12/2020,401706,4271489,801,89995,174,0,102,0,71565,24979,0,0,677,61741,4673195,62418,5,0
36,7/13/2020,402263,4322619,792,89995,175,0,103,0,71643,24989,0,0,557,51130,4724882,51687,10,0
36,7/14/2020,403175,4381752,820,89995,167,0,101,0,71692,24994,0,0,912,59133,4784927,60045,5,0
36,7/15/2020,404006,4444519,831,89995,165,0,94,0,71782,25003,0,0,831,62767,4848525,63598,9,0
36,7/16/2020,404775,4516435,813,89995,165,0,88,0,71867,25014,0,0,769,71916,4921210,72685,11,0
36,7/17/2020,405551,4593898,765,89995,179,0,98,0,71970,25024,0,0,776,77463,4999449,78239,10,0
37,3/4/2020,1,0,0,0,0,0,0,0,0,0,0,0,0,0,1,0,0,0
37,3/5/2020,1,0,0,0,0,0,0,0,0,0,0,0,0,0,1,0,0,0
37,3/6/2020,2,0,0,0,0,0,0,0,0,0,0,0,1,0,2,1,0,0
37,3/7/2020,2,0,0,0,0,0,0,0,0,0,0,0,0,0,2,0,0,0
37,3/8/2020,2,0,0,0,0,0,0,0,0,0,0,0,0,0,2,0,0,0
37,3/9/2020,2,0,0,0,0,0,0,0,0,0,0,0,0,0,2,0,0,0
37,3/10/2020,7,0,0,0,0,0,0,0,0,0,0,0,5,0,7,5,0,0
37,3/11/2020,7,0,0,0,0,0,0,0,0,0,0,0,0,0,7,0,0,0
37,3/12/2020,12,60,0,0,0,0,0,0,0,0,0,0,5,60,72,65,0,0
37,3/13/2020,15,86,0,0,0,0,0,0,0,0,0,0,3,26,101,29,0,0
37,3/14/2020,23,137,0,0,0,0,0,0,0,0,0,0,8,51,160,59,0,0
37,3/15/2020,32,227,0,0,0,0,0,0,0,0,0,0,9,90,259,99,0,0
37,3/16/2020,33,296,0,0,0,0,0,0,0,0,0,0,1,69,329,70,0,0
37,3/17/2020,40,474,0,0,0,0,0,0,0,0,0,0,7,178,514,185,0,0
37,3/18/2020,63,1787,0,0,0,0,0,0,0,0,0,0,23,1313,1850,1336,0,0
37,3/19/2020,97,2408,0,0,0,0,0,0,0,0,0,0,34,621,2505,655,0,0
37,3/20/2020,137,3096,0,0,0,0,0,0,0,0,0,0,40,688,3233,728,0,0
37,3/21/2020,184,5092,0,0,0,0,0,0,0,0,0,0,47,1996,5276,2043,0,0
37,3/22/2020,255,6183,0,0,0,0,0,0,0,0,0,0,71,1091,6438,1162,0,0
37,3/23/2020,297,8141,0,0,0,0,0,0,0,0,0,0,42,1958,8438,2000,0,0
37,3/24/2020,398,8141,0,0,0,0,0,0,0,0,0,0,101,0,8539,101,0,0
37,3/25/2020,504,9985,29,0,0,0,0,0,0,1,0,0,106,1844,10489,1950,1,0
37,3/26/2020,636,12274,29,0,0,0,0,0,0,2,0,0,132,2289,12910,2421,1,0
37,3/27/2020,763,14373,77,0,0,0,0,0,0,3,0,0,127,2099,15136,2226,1,0
37,3/28/2020,935,16592,87,0,0,0,0,0,0,4,0,0,172,2219,17527,2391,1,0
37,3/29/2020,1040,17905,91,0,0,0,0,0,0,4,0,0,105,1313,18945,1418,0,0
37,3/30/2020,1307,19557,137,0,0,0,0,0,0,6,0,0,267,1652,20864,1919,2,0
37,3/31/2020,1498,21608,157,0,0,0,0,0,0,8,0,0,191,2051,23106,2242,2,0
37,4/1/2020,1584,24659,204,0,0,0,0,0,0,10,0,0,86,3051,26243,3137,2,0
37,4/2/2020,1857,26822,184,0,0,0,0,0,0,16,0,0,273,2163,28679,2436,6,0
37,4/3/2020,2093,29505,184,0,0,0,0,0,0,19,0,0,236,2683,31598,2919,3,0
37,4/4/2020,2402,36371,271,0,0,0,0,0,0,24,0,0,309,6866,38773,7175,5,0
37,4/5/2020,2585,37460,261,0,0,0,0,0,0,31,0,0,183,1089,40045,1272,7,0
37,4/6/2020,2870,37856,270,0,0,0,0,0,0,33,0,0,285,396,40726,681,2,0
37,4/7/2020,3221,37861,354,0,0,0,0,0,0,46,0,0,351,5,41082,356,13,0
37,4/8/2020,3426,39561,386,0,0,0,0,0,0,53,0,0,205,1700,42987,1905,7,0
37,4/9/2020,3651,44158,398,0,0,0,0,0,0,65,0,0,225,4597,47809,4822,12,0
37,4/10/2020,3908,53737,423,0,0,0,0,0,0,74,0,0,257,9579,57645,9836,9,0
37,4/11/2020,4312,56081,362,0,0,0,0,0,0,80,0,0,404,2344,60393,2748,6,0
37,4/12/2020,4520,57619,331,0,0,0,0,0,0,81,0,0,208,1538,62139,1746,1,0
37,4/13/2020,4816,58572,313,0,0,0,0,0,0,86,0,0,296,953,63388,1249,5,0
37,4/14/2020,5024,60015,418,0,0,0,0,0,0,108,0,0,208,1443,65039,1651,22,0
37,4/15/2020,5123,62704,431,0,0,0,0,0,0,117,0,0,99,2689,67827,2788,9,0
37,4/16/2020,5465,65452,452,0,0,0,0,0,0,131,0,0,342,2748,70917,3090,14,0
37,4/17/2020,5859,67122,429,0,0,0,0,0,0,152,0,0,394,1670,72981,2064,21,0
37,4/18/2020,6140,70071,388,0,0,0,0,0,0,164,0,0,281,2949,76211,3230,12,0
37,4/19/2020,6493,72279,465,0,0,0,0,0,0,172,0,0,353,2208,78772,2561,8,0
37,4/20/2020,6764,72720,373,0,0,0,0,0,0,179,0,0,271,441,79484,712,7,0
37,4/21/2020,6951,76380,427,0,0,0,0,0,0,213,0,0,187,3660,83331,3847,34,0
37,4/22/2020,7220,83116,434,0,0,0,0,0,0,242,0,0,269,6736,90336,7005,29,0
37,4/23/2020,7608,88577,486,0,0,0,0,0,0,253,0,0,388,5461,96185,5849,11,0
37,4/24/2020,8052,92532,477,0,0,0,0,0,0,269,0,0,444,3955,100584,4399,16,0
37,4/25/2020,8623,96642,456,0,0,0,0,0,0,289,0,0,571,4110,105265,4681,20,0
37,4/26/2020,8830,99064,451,0,0,0,0,0,0,299,0,0,207,2422,107894,2629,10,0
37,4/27/2020,9142,100778,473,0,0,0,0,0,0,306,0,0,312,1714,109920,2026,7,0
37,4/28/2020,9568,103184,463,0,0,0,0,0,0,342,0,0,426,2406,112752,2832,36,0
37,4/29/2020,9948,108492,551,0,0,0,0,0,0,354,0,0,380,5308,118440,5688,12,0
37,4/30/2020,10509,117527,546,0,0,0,0,0,0,378,0,0,561,9035,128036,9596,24,0
37,5/1/2020,10923,122909,547,0,0,0,0,0,0,399,0,0,414,5382,133832,5796,21,0
37,5/2/2020,11509,127966,502,0,0,0,0,0,0,420,0,0,586,5057,139475,5643,21,0
37,5/3/2020,11664,132171,475,0,0,0,0,0,0,422,0,0,155,4205,143835,4360,2,0
37,5/4/2020,11848,134591,498,0,0,0,0,0,0,430,0,0,184,2420,146439,2604,8,0
37,5/5/2020,12256,139544,534,0,0,0,0,0,0,452,0,0,408,4953,151800,5361,22,0
37,5/6/2020,12758,151724,516,0,0,0,0,0,0,477,0,0,502,12180,164482,12682,25,0
37,5/7/2020,13397,157931,525,0,0,0,0,0,0,507,0,0,639,6207,171328,6846,30,0
37,5/8/2020,13868,164745,515,0,0,0,0,0,0,527,0,0,471,6814,178613,7285,20,0
37,5/9/2020,14360,172002,513,0,0,0,0,0,0,544,0,0,492,7257,186362,7749,17,0
37,5/10/2020,14764,177371,442,0,0,0,0,0,0,547,0,0,404,5369,192135,5773,3,0
37,5/11/2020,15045,180820,464,0,0,0,0,0,9115,550,0,0,281,3449,195865,3730,3,0
37,5/12/2020,15346,186898,475,0,0,0,0,0,9115,577,577,0,301,6078,202244,6379,27,0
37,5/13/2020,15816,194641,521,0,0,0,0,0,9115,597,597,0,470,7743,210457,8213,20,0
37,5/14/2020,16507,202761,507,0,0,0,0,0,9115,615,615,0,691,8120,219268,8811,18,0
37,5/15/2020,17129,214418,492,0,0,0,0,0,9115,641,641,0,622,11657,231547,12279,26,0
37,5/16/2020,17982,220604,481,0,0,0,0,0,9115,652,652,0,853,6186,238586,7039,11,0
37,5/17/2020,18512,230432,493,0,0,0,0,0,9115,659,659,0,530,9828,248944,10358,7,0
37,5/18/2020,19023,236732,511,0,0,0,0,0,11637,661,661,0,511,6300,255755,6811,2,0
37,5/19/2020,19700,245308,585,0,0,0,0,0,11637,691,691,0,677,8576,265008,9253,30,0
37,5/20/2020,20122,257481,554,0,0,0,0,0,11637,702,702,0,422,12173,277603,12595,11,0
37,5/21/2020,20860,269785,578,0,0,0,0,0,11637,716,716,0,738,12304,290645,13042,14,0
37,5/22/2020,21618,281606,568,0,0,0,0,0,11637,728,728,0,758,11821,303224,12579,12,0
37,5/23/2020,22725,306857,589,0,0,0,0,0,11637,737,737,0,1107,25251,329582,26358,9,0
37,5/24/2020,23222,313434,587,0,0,0,0,0,11637,744,744,0,497,6577,336656,7074,7,0
37,5/25/2020,23964,320726,627,0,0,0,0,0,14954,754,754,0,742,7292,344690,8034,10,0
37,5/26/2020,24140,328191,621,0,0,0,0,0,14954,766,766,0,176,7465,352331,7641,12,0
37,5/27/2020,24628,339528,702,0,0,0,0,0,14954,794,794,0,488,11337,364156,11825,28,0
37,5/28/2020,25412,349780,708,0,0,0,0,0,14954,827,827,0,784,10252,375192,11036,33,0
37,5/29/2020,26488,364743,680,0,0,0,0,0,14954,859,859,0,1076,14963,391231,16039,32,0
37,5/30/2020,27673,376484,638,0,0,0,0,0,14954,877,877,0,1185,11741,404157,12926,18,0
37,5/31/2020,28589,387700,649,0,0,0,0,0,14954,886,886,0,916,11216,416289,12132,9,0
37,6/1/2020,29263,392645,650,0,0,0,0,0,18860,898,898,0,674,4945,421908,5619,12,0
37,6/2/2020,29889,405032,716,0,0,0,0,0,18860,921,921,0,626,12387,434921,13013,23,0
37,6/3/2020,30777,418486,684,0,0,0,0,0,18860,939,939,0,888,13454,449263,14342,18,0
37,6/4/2020,31966,436336,659,0,0,0,0,0,18860,960,960,0,1189,17850,468302,19039,21,0
37,6/5/2020,33255,448892,717,0,0,0,0,0,18860,966,966,0,1289,12556,482147,13845,6,0
37,6/6/2020,34625,462725,708,0,0,0,0,0,18860,992,992,0,1370,13833,497350,15203,26,0
37,6/7/2020,35546,475680,696,0,0,0,0,0,18860,996,996,0,921,12955,511226,13876,4,0
37,6/8/2020,36484,483629,739,0,0,0,0,0,23653,1006,1006,0,938,7949,520113,8887,10,0
37,6/9/2020,37160,498551,774,0,0,0,0,0,23653,1029,1029,0,676,14922,535711,15598,23,0
37,6/10/2020,38171,515479,780,0,0,0,0,0,23653,1053,1053,0,1011,16928,553650,17939,24,0
37,6/11/2020,39481,533196,812,0,0,0,0,0,23653,1064,1064,0,1310,17717,572677,19027,11,0
37,6/12/2020,41249,554448,760,0,0,0,0,0,23653,1092,1092,0,1768,21252,595697,23020,28,0
37,6/13/2020,42676,569014,823,0,0,0,0,0,23653,1104,1104,0,1427,14566,611690,15993,12,0
37,6/14/2020,44119,583011,798,0,0,0,0,0,23653,1109,1109,0,1443,13997,627130,15440,5,0
37,6/15/2020,45102,593377,797,0,0,0,0,0,29219,1118,1118,0,983,10366,638479,11349,9,0
37,6/16/2020,45853,605568,829,0,0,0,0,0,29219,1154,1154,0,751,12191,651421,12942,36,0
37,6/17/2020,46855,620567,846,0,0,0,0,0,29219,1168,1168,0,1002,14999,667422,16001,14,0
37,6/18/2020,48188,645490,857,0,0,0,0,0,29219,1175,1175,0,1333,24923,693678,26256,7,0
37,6/19/2020,49840,662473,871,0,0,0,0,0,29219,1197,1197,0,1652,16983,712313,18635,22,0
37,6/20/2020,51389,679952,883,0,0,0,0,0,29219,1212,1212,0,1549,17479,731341,19028,15,0
37,6/21/2020,52801,692974,845,0,0,0,0,0,29219,1220,1220,0,1412,13022,745775,14434,8,0
37,6/22/2020,53605,703740,870,0,0,0,0,0,36921,1223,1223,0,804,10766,757345,11570,3,0
37,6/23/2020,54453,719375,915,0,0,0,0,0,36921,1251,1251,0,848,15635,773828,16483,28,0
37,6/24/2020,56174,735111,906,0,0,0,0,0,36921,1266,1266,0,1721,15736,791285,17457,15,0
37,6/25/2020,57183,754095,891,0,0,0,0,0,36921,1284,1284,0,1009,18984,811278,19993,18,0
37,6/26/2020,58818,777907,892,0,0,0,0,0,36921,1303,1303,0,1635,23812,836725,25447,19,0
37,6/27/2020,60537,794594,888,0,0,0,0,0,36921,1312,1312,0,1719,16687,855131,18406,9,0
37,6/28/2020,62142,809763,890,0,0,0,0,0,36921,1322,1322,0,1605,15169,871905,16774,10,0
37,6/29/2020,63484,822821,843,0,0,0,0,0,45538,1325,1325,0,1342,13058,886305,14400,3,0
37,6/30/2020,64670,845363,908,0,0,0,0,0,45538,1343,1343,0,1186,22542,910033,23728,18,0
37,7/1/2020,66513,875725,901,0,0,0,0,0,45538,1373,1373,0,1843,30362,942238,32205,30,0
37,7/2/2020,68142,902978,912,0,0,0,0,0,45538,1391,1391,0,1629,27253,971120,28882,18,0
37,7/3/2020,70241,929052,951,0,0,0,0,0,45538,1392,1392,0,2099,26074,999293,28173,1,0
37,7/4/2020,71654,946642,945,0,0,0,0,0,45538,1395,1395,0,1413,17590,1018296,19003,3,0
37,7/5/2020,72983,963855,949,0,0,0,0,0,45538,1396,1396,0,1329,17213,1036838,18542,1,0
37,7/6/2020,74529,977317,982,0,0,0,0,0,55318,1398,1398,0,1546,13462,1051846,15008,2,0
37,7/7/2020,75875,995415,989,0,0,0,0,0,55318,1420,1420,0,1346,18098,1071290,19444,22,0
37,7/8/2020,77310,1019372,994,0,0,0,0,0,55318,1441,1441,0,1435,23957,1096682,25392,21,0
37,7/9/2020,79349,1042462,1034,0,0,0,0,0,55318,1461,1461,0,2039,23090,1121811,25129,20,0
37,7/10/2020,81331,1069281,1046,0,0,0,0,0,55318,1479,1479,0,1982,26819,1150612,28801,18,0
37,7/11/2020,83793,1092265,1093,0,0,0,0,0,55318,1499,1499,0,2462,22984,1176058,25446,20,0
37,7/12/2020,85701,1113874,1070,0,0,0,0,0,55318,1503,1503,0,1908,21609,1199575,23517,4,0
37,7/13/2020,87528,1132958,1040,0,0,0,0,0,67124,1510,1510,0,1827,19084,1220486,20911,7,0
37,7/14/2020,89484,1165362,1109,0,0,0,0,0,67124,1552,1552,0,1956,32404,1254846,34360,42,0
37,7/15/2020,91266,1193371,1142,0,0,0,0,0,67124,1568,1568,0,1782,28009,1284637,29791,16,0
37,7/16/2020,93426,1219331,1134,0,0,0,0,0,67124,1588,1588,0,2160,25960,1312757,28120,20,0
37,7/17/2020,95477,1248497,1180,0,0,0,0,0,67124,1606,1606,0,2051,29166,1343974,31217,18,0
38,3/7/2020,0,0,0,0,0,0,0,0,0,0,0,0,0,0,0,0,0,0
38,3/8/2020,0,0,0,0,0,0,0,0,0,0,0,0,0,0,0,0,0,0
38,3/9/2020,0,0,0,0,0,0,0,0,0,0,0,0,0,0,0,0,0,0
38,3/10/2020,0,6,0,0,0,0,0,0,0,0,0,0,0,6,6,6,0,0
38,3/11/2020,0,7,0,0,0,0,0,0,0,0,0,0,0,1,7,1,0,0
38,3/12/2020,1,12,0,0,0,0,0,0,0,0,0,0,1,5,13,6,0,0
38,3/13/2020,1,39,0,0,0,0,0,0,0,0,0,0,0,27,40,27,0,0
38,3/14/2020,1,54,0,0,0,0,0,0,0,0,0,0,0,15,55,15,0,0
38,3/15/2020,1,95,0,0,0,0,0,0,0,0,0,0,0,41,96,41,0,0
38,3/16/2020,1,123,0,0,0,0,0,0,0,0,0,0,0,28,124,28,0,0
38,3/17/2020,3,220,0,0,0,0,0,0,0,0,0,0,2,97,223,99,0,0
38,3/18/2020,6,268,0,0,0,0,0,0,0,0,0,0,3,48,274,51,0,0
38,3/19/2020,15,493,0,0,0,0,0,0,0,0,0,0,9,225,508,234,0,0
38,3/20/2020,20,800,0,0,0,0,0,0,0,0,0,0,5,307,820,312,0,0
38,3/21/2020,28,1141,0,3,0,0,0,0,0,0,0,0,8,341,1169,349,0,3
38,3/22/2020,28,1260,0,3,0,0,0,0,0,0,0,0,0,119,1288,119,0,0
38,3/23/2020,30,1353,0,4,0,0,0,0,0,0,0,0,2,93,1383,95,0,1
38,3/24/2020,34,1454,0,5,0,0,0,0,0,0,0,0,4,101,1488,105,0,1
38,3/25/2020,39,1734,0,8,0,0,0,0,0,0,0,0,5,280,1773,285,0,3
38,3/26/2020,52,2039,0,10,0,0,0,0,0,0,0,0,13,305,2091,318,0,2
38,3/27/2020,65,2427,0,13,0,0,0,0,15,0,0,0,13,388,2492,401,0,3
38,3/28/2020,83,2809,0,16,0,0,0,0,16,1,0,0,18,382,2892,400,1,3
38,3/29/2020,98,3355,0,17,0,0,0,0,18,1,0,0,15,546,3453,561,0,1
38,3/30/2020,109,3728,0,19,0,0,0,0,19,2,0,0,11,373,3837,384,1,2
38,3/31/2020,126,4131,0,21,0,0,0,0,30,3,0,0,17,403,4257,420,1,2
38,4/1/2020,142,4351,0,23,0,0,0,0,34,3,0,0,16,220,4493,236,0,2
38,4/2/2020,159,4821,0,28,0,0,0,0,43,3,0,0,17,470,4980,487,0,5
38,4/3/2020,173,5625,0,29,0,0,0,0,55,3,0,0,14,804,5798,818,0,1
38,4/4/2020,186,6021,0,30,0,0,0,0,63,3,0,0,13,396,6207,409,0,1
38,4/5/2020,207,6580,20,31,0,0,0,0,63,3,0,0,21,559,6787,580,0,1
38,4/6/2020,225,6988,19,32,0,0,0,0,74,3,0,0,18,408,7213,426,0,1
38,4/7/2020,237,7466,18,33,0,0,0,0,82,4,0,0,12,478,7703,490,1,1
38,4/8/2020,251,8301,16,34,0,0,0,0,98,4,0,0,14,835,8552,849,0,1
38,4/9/2020,269,8721,14,34,0,0,0,0,101,5,0,0,18,420,8990,438,1,0
38,4/10/2020,278,9330,13,36,0,0,0,0,105,6,0,0,9,609,9608,618,1,2
38,4/11/2020,293,9787,10,36,0,0,0,0,119,7,0,0,15,457,10080,472,1,0
38,4/12/2020,308,10042,12,39,0,0,0,0,121,8,0,0,15,255,10350,270,1,3
38,4/13/2020,331,10450,13,40,0,0,0,0,127,8,0,0,23,408,10781,431,0,1
38,4/14/2020,341,10575,13,42,0,0,0,0,138,9,0,0,10,125,10916,135,1,2
38,4/15/2020,365,10952,13,44,0,0,0,0,142,9,0,0,24,377,11317,401,0,2
38,4/16/2020,393,11311,14,45,0,0,0,0,163,9,0,0,28,359,11704,387,0,1
38,4/17/2020,439,11903,16,47,0,0,0,0,172,9,0,0,46,592,12342,638,0,2
38,4/18/2020,528,12435,13,47,0,0,0,0,183,9,0,0,89,532,12963,621,0,0
38,4/19/2020,585,13045,15,51,0,0,0,0,189,10,0,0,57,610,13630,667,1,4
38,4/20/2020,627,14120,17,53,0,0,0,0,189,13,0,0,42,1075,14747,1117,3,2
38,4/21/2020,644,14343,17,54,0,0,0,0,214,13,0,0,17,223,14987,240,0,1
38,4/22/2020,679,14910,23,62,0,0,0,0,229,14,0,0,35,567,15589,602,1,8
38,4/23/2020,709,15621,18,65,0,0,0,0,269,15,0,0,30,711,16330,741,1,3
38,4/24/2020,748,16701,17,67,0,0,0,0,285,15,0,0,39,1080,17449,1119,0,2
38,4/25/2020,803,18547,17,70,0,0,0,0,310,16,0,0,55,1846,19350,1901,1,3
38,4/26/2020,867,19850,18,71,0,0,0,0,326,17,0,0,64,1303,20717,1367,1,1
38,4/27/2020,942,21492,23,77,0,0,0,0,350,19,0,0,75,1642,22434,1717,2,6
38,4/28/2020,991,22732,25,79,0,0,0,0,409,19,0,0,49,1240,23723,1289,0,2
38,4/29/2020,1033,24503,28,82,0,0,0,0,437,19,0,0,42,1771,25536,1813,0,3
38,4/30/2020,1067,26393,30,85,0,0,0,0,458,19,0,0,34,1890,27460,1924,0,3
38,5/1/2020,1107,28418,27,86,0,0,0,0,482,23,0,0,40,2025,29525,2065,4,1
38,5/2/2020,1153,30394,32,90,0,0,0,0,510,24,0,0,46,1976,31547,2022,1,4
38,5/3/2020,1191,32162,31,90,0,0,0,0,517,16,16,0,38,1768,33353,1806,-8,0
38,5/4/2020,1225,33529,31,94,0,0,0,0,540,15,15,0,34,1367,34754,1401,-1,4
38,5/5/2020,1266,35155,31,95,0,0,0,0,559,17,17,0,41,1626,36421,1667,2,1
38,5/6/2020,1323,37309,32,97,0,0,0,0,582,22,22,0,57,2154,38632,2211,5,2
38,5/7/2020,1371,39496,35,102,0,0,0,0,601,23,23,0,48,2187,40867,2235,1,5
38,5/8/2020,1425,41076,33,104,0,0,0,0,714,24,24,0,54,1580,42501,1634,1,2
38,5/9/2020,1464,42469,34,110,0,0,0,0,762,24,24,0,39,1393,43933,1432,0,6
38,5/10/2020,1491,43378,29,110,0,0,0,0,792,24,24,0,27,909,44869,936,0,0
38,5/11/2020,1518,45496,34,115,0,0,0,0,846,24,24,0,27,2118,47014,2145,0,5
38,5/12/2020,1571,46261,38,122,0,0,0,0,877,25,25,0,53,765,47832,818,1,7
38,5/13/2020,1647,47298,37,127,0,0,0,0,969,29,29,0,76,1037,48945,1113,4,5
38,5/14/2020,1647,48599,38,129,0,0,0,0,1007,31,31,0,0,1301,50246,1301,2,2
38,5/15/2020,1761,49954,35,130,0,0,0,0,1071,35,35,0,114,1355,51715,1469,4,1
38,5/16/2020,1848,51639,33,130,0,0,0,0,1111,35,35,0,87,1685,53487,1772,0,0
38,5/17/2020,1900,53321,30,130,0,0,0,0,1178,35,35,0,52,1682,55221,1734,0,0
38,5/18/2020,1931,54630,32,133,0,0,0,0,1219,37,37,0,31,1309,56561,1340,2,3
38,5/19/2020,1994,55737,32,135,0,0,0,0,1269,37,37,0,63,1107,57731,1170,0,2
38,5/20/2020,2095,57105,38,142,0,0,0,0,1302,37,37,0,101,1368,59200,1469,0,7
38,5/21/2020,2229,59050,39,144,0,0,0,0,1340,38,38,0,134,1945,61279,2079,1,2
38,5/22/2020,2317,60513,39,147,0,0,0,0,1405,39,39,0,88,1463,62830,1551,1,3
38,5/23/2020,2365,61783,39,150,0,0,0,0,1451,39,39,0,48,1270,64148,1318,0,3
38,5/24/2020,2418,63070,40,152,0,0,0,0,1496,39,39,0,53,1287,65488,1340,0,2
38,5/25/2020,2457,63893,41,154,0,0,0,0,1551,39,39,0,39,823,66350,862,0,2
38,5/26/2020,2422,64432,40,156,0,0,0,0,1701,40,40,0,-35,539,66854,504,1,2
38,5/27/2020,2439,64901,40,161,0,0,0,0,1762,44,41,3,17,469,67340,486,4,5
38,5/28/2020,2481,65773,35,161,0,0,0,0,1793,48,45,3,42,872,68254,914,4,0
38,5/29/2020,2520,66933,36,164,0,0,0,0,1882,48,45,3,39,1160,69453,1199,0,3
38,5/30/2020,2554,68427,34,165,0,0,0,0,1943,48,45,3,34,1494,70981,1528,0,1
38,5/31/2020,2577,69463,36,167,0,0,0,0,1959,48,45,3,23,1036,72040,1059,0,2
38,6/1/2020,2625,70676,35,169,0,0,0,0,2078,50,47,3,48,1213,73301,1261,2,2
38,6/2/2020,2646,70998,34,170,0,0,0,0,2127,54,51,3,21,322,73644,343,4,1
38,6/3/2020,2679,71823,34,172,0,0,0,0,2169,54,51,3,33,825,74502,858,0,2
38,6/4/2020,2706,73038,32,175,0,0,0,0,2209,58,55,3,27,1215,75744,1242,4,3
38,6/5/2020,2745,74111,30,180,0,0,0,0,2242,59,56,3,39,1073,76856,1112,1,5
38,6/6/2020,2816,76064,29,182,0,0,0,0,2268,59,56,3,71,1953,78880,2024,0,2
38,6/7/2020,2861,77072,28,183,0,0,0,0,2307,59,56,3,45,1008,79933,1053,0,1
38,6/8/2020,2880,77300,29,184,0,0,0,0,2336,62,59,3,19,228,80180,247,3,1
38,6/9/2020,2901,77765,32,189,0,0,0,0,2450,65,62,3,21,465,80666,486,3,5
38,6/10/2020,2941,78719,33,193,0,0,0,0,2482,67,64,3,40,954,81660,994,2,4
38,6/11/2020,2980,79808,32,193,0,0,0,0,2515,67,64,3,39,1089,82788,1128,0,0
38,6/12/2020,3016,81148,35,197,0,0,0,0,2573,67,64,3,36,1340,84164,1376,0,4
38,6/13/2020,3058,82815,35,197,0,0,0,0,2630,67,64,3,42,1667,85873,1709,0,0
38,6/14/2020,3080,83800,35,197,0,0,0,0,2658,67,64,3,22,985,86880,1007,0,0
38,6/15/2020,3101,84675,31,197,0,0,0,0,2683,68,65,3,21,875,87776,896,1,0
38,6/16/2020,3124,85527,26,200,0,0,0,0,2720,69,66,3,23,852,88651,875,1,3
38,6/17/2020,3166,86508,25,201,0,0,0,0,2756,70,66,4,42,981,89674,1023,1,1
38,6/18/2020,3193,87461,26,208,0,0,0,0,2809,70,64,6,27,953,90654,980,0,7
38,6/19/2020,3226,89380,26,210,0,0,0,0,2840,71,65,6,33,1919,92606,1952,1,2
38,6/20/2020,3251,90980,28,213,0,0,0,0,2882,71,65,6,25,1600,94231,1625,0,3
38,6/21/2020,3288,92885,31,216,0,0,0,0,2910,71,65,6,37,1905,96173,1942,0,3
38,6/22/2020,3313,94140,31,218,0,0,0,0,2952,72,66,6,25,1255,97453,1280,1,2
38,6/23/2020,3320,94233,28,218,0,0,0,0,3008,73,67,6,7,93,97553,100,1,0
38,6/24/2020,3362,95327,27,219,0,0,0,0,3044,74,66,8,42,1094,98689,1136,1,1
38,6/25/2020,3393,96051,25,222,0,0,0,0,3064,76,67,9,31,724,99444,755,2,3
38,6/26/2020,3421,97465,23,222,0,0,0,0,3090,77,68,9,28,1414,100886,1442,1,0
38,6/27/2020,3458,99061,23,225,0,0,0,0,3119,77,68,9,37,1596,102519,1633,0,3
38,6/28/2020,3495,100430,24,226,0,0,0,0,3139,77,68,9,37,1369,103925,1406,0,1
38,6/29/2020,3539,102152,25,227,0,0,0,0,3163,77,68,9,44,1722,105691,1766,0,1
38,6/30/2020,3576,102546,25,231,0,0,0,0,3195,78,69,9,37,394,106122,431,1,4
38,7/1/2020,3615,103611,20,234,0,0,0,0,3210,78,69,9,39,1065,107226,1104,0,3
38,7/2/2020,3657,104538,19,234,0,0,0,0,3235,78,69,9,42,927,108195,969,0,0
38,7/3/2020,3722,106852,20,237,0,0,0,0,3266,78,69,9,65,2314,110574,2379,0,3
38,7/4/2020,3779,108149,22,241,0,0,0,0,3288,78,69,9,57,1297,111928,1354,0,4
38,7/5/2020,3816,109312,22,242,0,0,0,0,3324,78,69,9,37,1163,113128,1200,0,1
38,7/6/2020,3849,109733,22,245,0,0,0,0,3350,78,69,9,33,421,113582,454,0,3
38,7/7/2020,3898,110459,24,248,0,0,0,0,3413,81,72,9,49,726,114357,775,3,3
38,7/8/2020,3971,111868,26,252,0,0,0,0,3447,78,74,4,73,1409,115839,1482,-3,4
38,7/9/2020,4070,113779,30,257,0,0,0,0,3464,78,74,4,99,1911,117849,2010,0,5
38,7/10/2020,4154,115442,33,260,0,0,0,0,3496,78,74,4,84,1663,119596,1747,0,3
38,7/11/2020,4243,116608,31,263,0,0,0,0,3533,78,74,4,89,1166,120851,1255,0,3
38,7/12/2020,4334,118145,38,271,0,0,0,0,3570,78,74,4,91,1537,122479,1628,0,8
38,7/13/2020,4442,119436,43,277,0,0,0,0,3653,78,74,4,108,1291,123878,1399,0,6
38,7/14/2020,4493,120540,42,280,0,0,0,0,3685,78,74,4,51,1104,125033,1155,0,3
38,7/15/2020,4565,121999,42,284,0,0,0,0,3760,81,77,4,72,1459,126564,1531,3,4
38,7/16/2020,4668,123388,38,285,0,0,0,0,3796,82,78,4,103,1389,128056,1492,1,1
38,7/17/2020,4792,124683,36,290,0,0,0,0,3903,82,78,4,124,1295,129475,1419,0,5
39,3/5/2020,0,7,0,0,0,0,0,0,0,0,0,0,0,0,7,0,0,0
39,3/6/2020,0,8,0,0,0,0,0,0,0,0,0,0,0,1,8,1,0,0
39,3/7/2020,0,9,0,0,0,0,0,0,0,0,0,0,0,1,9,1,0,0
39,3/8/2020,0,10,0,0,0,0,0,0,0,0,0,0,0,1,10,1,0,0
39,3/9/2020,3,11,0,0,0,0,0,0,0,0,0,0,3,1,14,4,0,0
39,3/10/2020,3,14,0,0,0,0,0,0,0,0,0,0,0,3,17,3,0,0
39,3/11/2020,4,21,0,0,0,0,0,0,0,0,0,0,1,7,25,8,0,0
39,3/12/2020,5,30,0,0,0,0,0,0,0,0,0,0,1,9,35,10,0,0
39,3/13/2020,13,50,0,0,0,0,0,0,0,0,0,0,8,20,63,28,0,0
39,3/14/2020,13,50,0,0,0,0,0,0,0,0,0,0,0,0,63,0,0,0
39,3/15/2020,36,139,0,0,0,0,0,0,0,0,0,0,23,89,175,112,0,0
39,3/16/2020,50,140,0,0,0,0,0,0,0,0,0,0,14,1,190,15,0,0
39,3/17/2020,67,140,0,0,0,0,0,0,0,0,0,0,17,0,207,17,0,0
39,3/18/2020,88,140,0,0,0,0,0,0,0,0,0,0,21,0,228,21,0,0
39,3/19/2020,119,140,0,0,0,0,0,0,0,0,0,0,31,0,259,31,0,0
39,3/20/2020,169,140,0,0,0,0,0,0,0,1,0,0,50,0,309,50,1,0
39,3/21/2020,247,140,0,58,0,0,0,0,0,3,0,0,78,0,387,78,2,58
39,3/22/2020,351,140,0,83,0,0,0,0,0,3,0,0,104,0,491,104,0,25
39,3/23/2020,442,140,0,104,0,0,0,0,0,6,0,0,91,0,582,91,3,21
39,3/24/2020,564,140,0,145,0,0,0,0,0,8,0,0,122,0,704,122,2,41
39,3/25/2020,704,14060,0,182,0,74,0,0,0,10,0,0,140,13920,14764,14060,2,37
39,3/26/2020,867,16449,0,223,0,91,0,0,0,15,0,0,163,2389,17316,2552,5,41
39,3/27/2020,1137,19012,0,276,0,107,0,0,0,19,0,0,270,2563,20149,2833,4,53
39,3/28/2020,1406,19012,0,344,0,123,0,0,0,25,0,0,269,0,20418,269,6,68
39,3/29/2020,1653,19012,0,403,0,139,0,0,0,29,0,0,247,0,20665,247,4,59
39,3/30/2020,1933,25342,0,475,0,163,0,0,0,39,0,0,280,6330,27275,6610,10,72
39,3/31/2020,2199,26992,0,585,0,198,0,0,0,55,0,0,266,1650,29191,1916,16,110
39,4/1/2020,2547,26992,0,679,0,222,0,0,0,65,0,0,348,0,29539,348,10,94
39,4/2/2020,2902,32016,0,802,0,260,0,0,0,81,0,0,355,5024,34918,5379,16,123
39,4/3/2020,3312,35063,0,895,0,288,0,0,0,91,0,0,410,3047,38375,3457,10,93
39,4/4/2020,3739,38132,0,1006,0,326,0,0,0,102,0,0,427,3069,41871,3496,11,111
39,4/5/2020,4043,39713,0,1104,0,346,0,0,0,119,0,0,304,1581,43756,1885,17,98
39,4/6/2020,4450,43928,0,1214,0,371,0,0,0,142,0,0,407,4215,48378,4622,23,110
39,4/7/2020,4782,46056,0,1354,0,417,0,0,0,167,0,0,332,2128,50838,2460,25,140
39,4/8/2020,5148,48193,0,1495,0,472,0,0,0,193,0,0,366,2137,53341,2503,26,141
39,4/9/2020,5512,50473,0,1612,0,497,0,0,0,213,0,0,364,2280,55985,2644,20,117
39,4/10/2020,5878,52695,0,1755,0,548,0,0,0,231,227,4,366,2222,58573,2588,18,143
39,4/11/2020,6250,54221,0,1859,0,572,0,0,0,247,242,5,372,1526,60471,1898,16,104
39,4/12/2020,6604,56639,0,1948,0,595,0,0,0,253,248,5,354,2418,63243,2772,6,89
39,4/13/2020,6975,58137,0,2033,0,613,0,0,0,274,268,6,371,1498,65112,1869,21,85
39,4/14/2020,7280,60721,0,2156,0,654,0,0,0,324,309,15,305,2584,68001,2889,50,123
39,4/15/2020,7791,63761,0,2237,0,677,0,0,0,361,346,15,511,3040,71552,3551,37,81
39,4/16/2020,8414,66426,0,2331,0,707,0,0,0,389,373,16,623,2665,74840,3288,28,94
39,4/17/2020,9107,68819,0,2424,0,740,0,0,0,418,401,17,693,2393,77926,3086,29,93
39,4/18/2020,10222,68819,0,2519,0,760,0,0,0,451,434,17,1115,0,79041,1115,33,95
39,4/19/2020,11602,75697,0,2565,0,765,0,0,0,471,453,18,1380,6878,87299,8258,20,46
39,4/20/2020,12919,77920,0,2653,0,798,0,0,0,509,491,18,1317,2223,90839,3540,38,88
39,4/21/2020,13725,80989,0,2779,0,838,0,0,0,557,538,19,806,3069,94714,3875,48,126
39,4/22/2020,14117,84389,0,2882,0,880,0,0,0,610,584,26,392,3400,98506,3792,53,103
39,4/23/2020,14694,88183,0,2960,0,900,0,0,0,656,618,38,577,3794,102877,4371,46,78
39,4/24/2020,15169,92528,0,3053,0,920,0,0,0,690,649,41,475,4345,107697,4820,34,93
39,4/25/2020,15587,96396,0,3115,0,938,0,0,0,711,671,40,418,3868,111983,4286,21,62
39,4/26/2020,15963,100423,0,3178,0,952,0,0,0,728,687,41,376,4027,116386,4403,17,63
39,4/27/2020,15699,103692,0,3232,0,978,0,0,0,753,712,41,-264,3269,119391,3005,25,54
39,4/28/2020,16128,106578,0,3340,0,1004,0,0,0,799,757,42,429,2886,122706,3315,46,108
39,4/29/2020,17303,111605,0,3421,0,1014,0,0,0,937,856,81,1175,5027,128908,6202,138,81
39,4/30/2020,18027,115863,0,3533,0,1035,0,0,0,975,898,77,724,4258,133890,4982,38,112
39,5/1/2020,18743,121763,0,3634,0,1056,0,0,0,1002,922,80,716,5900,140506,6616,27,101
39,5/2/2020,19335,126484,1003,3712,424,1066,267,0,0,1021,940,81,592,4721,145819,5313,19,78
39,5/3/2020,19914,130252,931,3769,393,1078,255,0,0,1038,957,81,579,3768,150166,4347,17,57
39,5/4/2020,20474,134681,1078,3809,412,1090,275,0,0,1056,975,81,560,4429,155155,4989,18,40
39,5/5/2020,20969,139766,1069,3956,402,1123,281,0,0,1135,1038,97,495,5085,160735,5580,79,147
39,5/6/2020,21576,147353,1045,4052,407,1151,275,0,0,1225,1114,111,607,7587,168929,8194,90,96
39,5/7/2020,22131,153928,1057,4140,418,1167,279,0,0,1271,1153,118,555,6575,176059,7130,46,88
39,5/8/2020,23016,161300,1060,4218,393,1188,274,0,0,1306,1185,121,885,7372,184316,8257,35,78
39,5/9/2020,23697,172973,929,4300,368,1200,222,0,0,1331,1214,117,681,11673,196670,12354,25,82
39,5/10/2020,24081,180781,962,4351,381,1205,254,0,0,1341,1220,121,384,7808,204862,8192,10,51
39,5/11/2020,24777,185753,1011,4413,391,1217,256,0,0,1357,1236,121,696,4972,210530,5668,16,62
39,5/12/2020,25250,192481,1032,4539,401,1232,270,0,0,1436,1303,133,473,6728,217731,7201,79,126
39,5/13/2020,25721,200133,924,4618,353,1248,244,0,0,1483,1347,136,471,7652,225854,8123,47,79
39,5/14/2020,26357,206995,953,4718,360,1268,253,0,0,1534,1388,146,636,6862,233352,7498,51,100
39,5/15/2020,26954,219228,944,4791,370,1277,260,0,0,1581,1431,150,597,12233,246182,12830,47,73
39,5/16/2020,27474,219228,866,4870,366,1277,251,0,0,1610,1457,153,520,0,246702,520,29,79
39,5/17/2020,27923,236539,914,4921,343,1305,230,0,0,1625,1472,153,449,17311,264462,17760,15,51
39,5/18/2020,28454,243395,912,4998,367,1328,247,0,0,1657,1504,153,531,6856,271849,7387,32,77
39,5/19/2020,28952,248650,913,5117,365,1357,234,0,0,1720,1556,164,498,5255,277602,5753,63,119
39,5/20/2020,29436,260092,902,5198,333,1369,248,0,0,1781,1603,178,484,11442,289528,11926,61,81
39,5/21/2020,30167,268911,892,5295,349,1397,258,0,0,1836,1653,183,731,8819,299078,9550,55,97
39,5/22/2020,30794,277006,879,5379,362,1416,232,0,0,1872,1691,181,627,8095,307800,8722,36,84
39,5/23/2020,31408,285086,858,5437,333,1429,223,0,0,1956,1756,200,614,8080,316494,8694,84,58
39,5/24/2020,31911,292642,864,5476,317,1438,205,0,0,1969,1769,200,503,7556,324553,8059,13,39
39,5/25/2020,32477,297857,872,5511,323,1443,211,0,0,1987,1788,199,566,5215,330334,5781,18,35
39,5/26/2020,33006,306394,937,5579,351,1450,232,0,0,2002,1803,199,529,8537,339400,9066,15,68
39,5/27/2020,33439,316286,885,5700,313,1492,217,0,0,2044,1842,202,433,9892,349725,10325,42,121
39,5/28/2020,33915,326097,812,5811,285,1516,190,0,0,2098,1888,210,476,9811,360012,10287,54,111
39,5/29/2020,34566,335324,833,5947,326,1533,222,0,0,2131,1921,210,651,9227,369890,9878,33,136
39,5/30/2020,35034,346913,806,6011,339,1548,219,0,0,2149,1938,211,468,11589,381947,12057,18,64
39,5/31/2020,35513,355395,779,6049,310,1556,213,0,0,2155,1944,211,479,8482,390908,8961,6,38
39,6/1/2020,35984,362082,761,6112,324,1569,223,0,0,2206,1993,213,471,6687,398066,7158,51,63
39,6/2/2020,36350,373558,697,6176,295,1583,204,0,0,2258,2041,217,366,11476,409908,11842,52,64
39,6/3/2020,36792,389313,704,6251,283,1604,198,0,0,2299,2080,219,442,15755,426105,16197,41,75
39,6/4/2020,37282,399969,693,6312,267,1623,181,0,0,2339,2117,222,490,10656,437251,11146,40,61
39,6/5/2020,37758,408437,671,6385,259,1632,168,0,0,2355,2135,220,476,8468,446195,8944,16,73
39,6/6/2020,38111,420415,628,6460,256,1650,155,0,0,2370,2148,222,353,11978,458526,12331,15,75
39,6/7/2020,38476,430548,603,6497,240,1657,167,0,0,2377,2155,222,365,10133,469024,10498,7,37
39,6/8/2020,38837,437981,644,6550,245,1668,158,0,0,2404,2177,227,361,7433,476818,7794,27,53
39,6/9/2020,39162,451228,639,6620,238,1708,153,0,0,2421,2196,225,325,13247,490390,13572,17,70
39,6/10/2020,39575,462309,575,6693,232,1714,159,0,0,2457,2231,226,413,11081,501884,11494,36,73
39,6/11/2020,40004,472579,563,6753,225,1732,155,0,0,2490,2263,227,429,10270,512583,10699,33,60
39,6/12/2020,40424,483294,547,6814,217,1745,144,0,0,2508,2280,228,420,10715,523718,11135,18,61
39,6/13/2020,40848,498050,516,6864,230,1754,152,0,0,2554,2324,230,424,14756,538898,15180,46,50
39,6/14/2020,41148,505072,511,6895,216,1762,145,0,0,2557,2327,230,300,7022,546220,7322,3,31
39,6/15/2020,41576,515592,513,6948,216,1776,157,0,0,2573,2342,231,428,10520,557168,10948,16,53
39,6/16/2020,42010,526123,528,7007,216,1784,151,0,0,2597,2362,235,434,10531,568133,10965,24,59
39,6/17/2020,42422,542141,541,7051,215,1797,148,0,0,2611,2377,234,412,16018,584563,16430,14,44
39,6/18/2020,43122,556902,547,7104,219,1807,149,0,0,2633,2401,232,700,14761,600024,15461,22,53
39,6/19/2020,43731,572305,525,7167,200,1820,133,0,0,2667,2430,237,609,15403,616036,16012,34,63
39,6/20/2020,44262,585703,482,7201,186,1833,118,0,0,2697,2460,237,531,13398,629965,13929,30,34
39,6/21/2020,44808,598413,496,7242,194,1844,119,0,0,2700,2463,237,546,12710,643221,13256,3,41
39,6/22/2020,45537,614064,549,7292,217,1852,124,0,0,2704,2467,237,729,15651,659601,16380,4,50
39,6/23/2020,46127,624310,570,7379,205,1876,126,0,0,2735,2497,238,590,10246,670437,10836,31,87
39,6/24/2020,46759,633928,592,7447,202,1886,119,0,0,2755,2516,239,632,9618,680687,10250,20,68
39,6/25/2020,47651,651979,624,7502,206,1897,121,0,0,2772,2530,242,892,18051,699630,18943,17,55
39,6/26/2020,48638,672914,624,7570,205,1904,116,0,0,2788,2545,243,987,20935,721552,21922,16,68
39,6/27/2020,49455,695384,561,7624,190,1916,106,0,0,2804,2561,243,817,22470,744839,23287,16,54
39,6/28/2020,50309,706456,661,7681,182,1946,101,0,0,2807,2564,243,854,11072,756765,11926,3,57
39,6/29/2020,51046,723336,669,7746,245,1961,115,0,0,2818,2575,243,737,16880,774382,17617,11,65
39,6/30/2020,51789,736140,722,7839,242,1994,115,0,0,2863,2615,248,743,12804,787929,13547,45,93
39,7/1/2020,52865,739140,724,7911,244,2008,116,0,0,2876,2626,250,1076,3000,792005,4076,13,72
39,7/2/2020,54166,739140,724,8038,244,2035,116,0,38987,2903,2653,250,1301,0,793306,1301,27,127
39,7/3/2020,55257,772900,740,8084,233,2044,100,0,39423,2903,2653,250,1091,33760,828157,34851,0,46
39,7/4/2020,56183,792187,691,8111,226,2052,111,0,39903,2907,2657,250,926,19287,848370,20213,4,27
39,7/5/2020,57151,811611,693,8172,236,2058,119,0,40460,2911,2661,250,968,19424,868762,20392,4,61
39,7/6/2020,57956,823456,837,8249,267,2077,140,0,40813,2927,2677,250,805,11845,881412,12650,16,77
39,7/7/2020,58904,837581,849,8383,289,2101,140,0,41438,2970,2718,252,948,14125,896485,15073,43,134
39,7/8/2020,60181,855071,890,8489,289,2127,155,0,42111,2991,2737,254,1277,17490,915252,18767,21,106
39,7/9/2020,61331,855071,890,8570,289,2146,155,0,42111,3006,2749,257,1150,0,916402,1150,15,81
39,7/10/2020,62856,896697,928,8701,289,2161,151,0,43435,3032,2776,256,1525,41626,959553,43151,26,131
39,7/11/2020,64214,918821,928,8770,299,2169,155,0,44101,3036,2780,256,1358,22124,983035,23482,4,69
39,7/12/2020,65592,940794,954,8842,289,2185,154,0,44663,3058,2801,257,1378,21973,1006386,23351,22,72
39,7/13/2020,66853,957898,949,8915,293,2201,159,0,45194,3064,2807,257,1261,17104,1024751,18365,6,73
39,7/14/2020,67995,975754,1017,9049,314,2223,156,0,46282,3069,2813,256,1142,17856,1043749,18998,5,134
39,7/15/2020,69311,993312,1027,9209,316,2259,146,0,47303,3075,2819,256,1316,17558,1062623,18874,6,160
39,7/16/2020,70601,1018192,1024,9324,310,2280,150,0,48330,3103,2849,254,1290,24880,1088793,26170,28,115
39,7/17/2020,72280,1043844,1016,9445,319,2305,161,0,49302,3112,2858,254,1679,25652,1116124,27331,9,121
40,3/7/2020,1,0,0,0,0,0,0,0,0,0,0,0,0,0,1,0,0,0
40,3/8/2020,1,8,0,0,0,0,0,0,0,0,0,0,0,8,9,8,0,0
40,3/9/2020,1,8,0,0,0,0,0,0,0,0,0,0,0,0,9,0,0,0
40,3/10/2020,2,15,0,0,0,0,0,0,0,0,0,0,1,7,17,8,0,0
40,3/11/2020,2,15,0,0,0,0,0,0,0,0,0,0,0,0,17,0,0,0
40,3/12/2020,3,36,0,0,0,0,0,0,0,0,0,0,1,21,39,22,0,0
40,3/13/2020,3,36,0,0,0,0,0,0,0,0,0,0,0,0,39,0,0,0
40,3/14/2020,4,36,0,0,0,0,0,0,0,0,0,0,1,0,40,1,0,0
40,3/15/2020,9,118,0,0,0,0,0,0,0,0,0,0,5,82,127,87,0,0
40,3/16/2020,10,174,0,0,0,0,0,0,0,0,0,0,1,56,184,57,0,0
40,3/17/2020,17,247,0,0,0,0,0,0,0,0,0,0,7,73,264,80,0,0
40,3/18/2020,29,378,0,0,0,0,0,0,0,0,0,0,12,131,407,143,0,0
40,3/19/2020,44,466,0,0,0,0,0,0,0,1,0,0,15,88,510,103,1,0
40,3/20/2020,49,538,0,0,0,0,0,0,0,1,0,0,5,72,587,77,0,0
40,3/21/2020,53,560,0,10,0,0,0,0,0,1,0,0,4,22,613,26,0,10
40,3/22/2020,67,669,0,11,0,0,0,0,0,2,0,0,14,109,736,123,1,1
40,3/23/2020,81,694,0,15,0,0,0,0,0,2,0,0,14,25,775,39,0,4
40,3/24/2020,106,735,0,25,0,0,0,0,0,3,0,0,25,41,841,66,1,10
40,3/25/2020,164,805,0,59,0,0,0,0,0,5,0,0,58,70,969,128,2,34
40,3/26/2020,248,958,0,86,0,0,0,0,0,7,0,0,84,153,1206,237,2,27
40,3/27/2020,322,1084,0,105,0,0,0,0,0,8,0,0,74,126,1406,200,1,19
40,3/28/2020,377,1180,0,126,0,0,0,0,0,15,0,0,55,96,1557,151,7,21
40,3/29/2020,429,1205,0,140,0,0,0,0,0,16,0,0,52,25,1634,77,1,14
40,3/30/2020,481,1207,0,153,103,0,0,0,0,17,0,0,52,2,1688,54,1,13
40,3/31/2020,565,1229,0,177,83,0,0,0,0,23,0,0,84,22,1794,106,6,24
40,4/1/2020,719,1248,174,219,98,0,0,0,0,30,0,0,154,19,1967,173,7,42
40,4/2/2020,879,1265,182,257,144,0,0,0,0,34,0,0,160,17,2144,177,4,38
40,4/3/2020,988,1315,171,289,123,0,0,0,383,38,0,0,109,50,2303,159,4,32
40,4/4/2020,1159,1362,0,316,0,0,0,0,0,42,0,0,171,47,2521,218,4,27
40,4/5/2020,1252,1401,0,330,0,0,0,0,0,46,0,0,93,39,2653,132,4,14
40,4/6/2020,1327,1422,161,340,143,0,0,0,522,51,0,0,75,21,2749,96,5,10
40,4/7/2020,1472,11821,186,376,137,0,0,0,612,67,0,0,145,10399,13293,10544,16,36
40,4/8/2020,1524,11821,188,390,120,0,0,0,686,79,0,0,52,0,13345,52,12,14
40,4/9/2020,1684,18595,188,415,120,0,0,0,686,80,0,0,160,6774,20279,6934,1,25
40,4/10/2020,1794,20370,186,428,122,0,0,0,790,88,0,0,110,1775,22164,1885,8,13
40,4/11/2020,1868,20790,383,446,191,0,0,0,865,94,0,0,74,420,22658,494,6,18
40,4/12/2020,1970,20790,383,446,191,0,0,0,865,96,0,0,102,0,22760,102,2,0
40,4/13/2020,2069,20790,383,457,191,0,0,0,865,99,0,0,99,0,22859,99,3,11
40,4/14/2020,2184,26085,194,488,107,0,0,0,1060,108,0,0,115,5295,28269,5410,9,31
40,4/15/2020,2263,26956,194,510,107,0,0,0,1115,123,0,0,79,871,29219,950,15,22
40,4/16/2020,2357,28542,236,528,163,0,0,0,1240,131,0,0,94,1586,30899,1680,8,18
40,4/17/2020,2465,31155,325,528,155,0,0,0,1331,136,0,0,108,2613,33620,2721,5,0
40,4/18/2020,2570,32966,307,541,136,0,0,0,1515,139,0,0,105,1811,35536,1916,3,13
40,4/19/2020,2599,32966,307,541,136,0,0,0,1575,140,0,0,29,0,35565,29,1,0
40,4/20/2020,2680,32966,307,541,136,0,0,0,1614,143,0,0,81,0,35646,81,3,0
40,4/21/2020,2807,41537,346,561,164,0,0,0,1702,164,0,0,127,8571,44344,8698,21,20
40,4/22/2020,2894,43019,298,588,147,0,0,0,1772,170,0,0,87,1482,45913,1569,6,27
40,4/23/2020,3017,43019,284,622,156,0,0,0,1884,179,0,0,123,0,46036,123,9,34
40,4/24/2020,3121,43019,310,637,155,0,0,0,1961,188,0,0,104,0,46140,104,9,15
40,4/25/2020,3193,49891,306,637,150,0,0,0,2080,194,0,0,72,6872,53084,6944,6,0
40,4/26/2020,3253,49891,306,653,150,0,0,0,2139,195,0,0,60,0,53144,60,1,16
40,4/27/2020,3280,49891,306,656,150,0,0,0,2167,197,0,0,27,0,53171,27,2,3
40,4/28/2020,3410,56289,288,656,118,0,0,0,2260,207,0,0,130,6398,59699,6528,10,0
40,4/29/2020,3473,57794,283,693,126,0,0,0,2319,214,0,0,63,1505,61267,1568,7,37
40,4/30/2020,3618,59804,291,703,127,0,0,0,2401,222,0,0,145,2010,63422,2155,8,10
40,5/1/2020,3748,59804,255,715,113,0,0,0,2467,230,0,0,130,0,63552,130,8,12
40,5/2/2020,3851,59804,236,743,92,0,0,0,2554,238,0,0,103,0,63655,103,8,28
40,5/3/2020,3972,59804,236,743,92,0,0,0,2635,238,0,0,121,0,63776,121,0,0
40,5/4/2020,4044,59804,236,753,92,0,0,0,2682,238,0,0,72,0,63848,72,0,10
40,5/5/2020,4127,75290,236,773,113,0,0,0,2830,247,0,0,83,15486,79417,15569,9,20
40,5/6/2020,4201,78689,230,773,102,0,0,0,2909,253,0,0,74,3399,82890,3473,6,0
40,5/7/2020,4330,82557,223,805,97,0,0,0,2985,260,0,0,129,3868,86887,3997,7,32
40,5/8/2020,4424,85433,228,805,96,0,0,0,3064,266,0,0,94,2876,89857,2970,6,0
40,5/9/2020,4490,91379,177,822,93,0,0,0,3154,270,0,0,66,5946,95869,6012,4,17
40,5/10/2020,4589,91379,177,826,93,0,0,0,3204,272,0,0,99,0,95968,99,2,4
40,5/11/2020,4613,91379,177,828,93,0,0,0,3241,274,0,0,24,0,95992,24,2,2
40,5/12/2020,4732,91379,190,828,83,0,0,0,3423,278,0,0,119,0,96111,119,4,0
40,5/13/2020,4852,104275,218,848,93,0,0,0,3559,278,0,0,120,12896,109127,13016,0,20
40,5/14/2020,4962,107221,217,858,102,0,0,0,3660,284,0,0,110,2946,112183,3056,6,10
40,5/15/2020,5086,113106,215,863,98,0,0,0,3801,285,0,0,124,5885,118192,6009,1,5
40,5/16/2020,5237,118162,180,878,73,0,0,0,3945,288,0,0,151,5056,123399,5207,3,15
40,5/17/2020,5310,118162,180,880,73,0,0,0,3983,288,0,0,73,0,123472,73,0,2
40,5/18/2020,5398,118162,76,885,45,0,0,0,4008,288,0,0,88,0,123560,88,0,5
40,5/19/2020,5489,133658,167,897,77,0,0,0,4135,294,0,0,91,15496,139147,15587,6,12
40,5/20/2020,5532,138839,209,905,92,0,0,0,4266,299,0,0,43,5181,144371,5224,5,8
40,5/21/2020,5680,143915,201,917,78,0,0,0,4361,304,0,0,148,5076,149595,5224,5,12
40,5/22/2020,5849,147318,190,926,94,0,0,0,4533,307,0,0,169,3403,153167,3572,3,9
40,5/23/2020,5960,154943,174,926,78,0,0,0,4645,311,0,0,111,7625,160903,7736,4,0
40,5/24/2020,6037,154943,174,938,78,0,0,0,4688,311,0,0,77,0,160980,77,0,12
40,5/25/2020,6090,154943,0,938,78,0,0,0,4714,313,0,0,53,0,161033,53,2,0
40,5/26/2020,6137,153804,174,941,78,0,0,0,4823,318,0,0,47,-1139,159941,-1092,5,3
40,5/27/2020,6229,172409,156,941,74,0,0,0,5135,322,0,0,92,18605,178638,18697,4,0
40,5/28/2020,6270,176136,181,975,80,0,0,0,5236,326,0,0,41,3727,182406,3768,4,34
40,5/29/2020,6338,181060,160,982,68,0,0,0,5340,329,0,0,68,4924,187398,4992,3,7
40,5/30/2020,6418,186700,154,982,65,0,0,0,5435,334,0,0,80,5640,193118,5720,5,0
40,5/31/2020,6506,186700,154,985,65,0,0,0,5492,334,0,0,88,0,193206,88,0,3
40,6/1/2020,6573,186700,154,986,65,0,0,0,5511,334,0,0,67,0,193273,67,0,1
40,6/2/2020,6692,197965,124,994,60,0,0,0,5599,339,0,0,119,11265,204657,11384,5,8
40,6/3/2020,6805,201247,136,1003,59,0,0,0,5711,341,0,0,113,3282,208052,3395,2,9
40,6/4/2020,6907,204815,148,1014,63,0,0,0,5781,344,0,0,102,3568,211722,3670,3,11
40,6/5/2020,6907,209564,164,1014,66,0,0,0,5781,344,0,0,0,4749,216471,4749,0,0
40,6/6/2020,7003,214598,158,1026,65,0,0,0,5867,345,0,0,96,5034,221601,5130,1,12
40,6/7/2020,7150,214598,158,1026,65,0,0,0,5981,348,0,0,147,0,221748,147,3,0
40,6/8/2020,7205,214598,158,1039,65,0,0,0,6014,348,0,0,55,0,221803,55,0,13
40,6/9/2020,7363,226678,148,1061,66,0,0,0,6073,353,0,0,158,12080,234041,12238,5,22
40,6/10/2020,7480,229817,150,1075,63,0,0,0,6166,355,0,0,117,3139,237297,3256,2,14
40,6/11/2020,7626,233819,153,1092,58,0,0,0,6263,357,0,0,146,4002,241445,4148,2,17
40,6/12/2020,7848,238366,154,1103,65,0,0,0,6391,359,0,0,222,4547,246214,4769,2,11
40,6/13/2020,8073,238366,154,1111,67,0,0,0,6495,359,0,0,225,0,246439,225,0,8
40,6/14/2020,8231,242587,149,1116,67,0,0,0,6578,359,0,0,158,4221,250818,4379,0,5
40,6/15/2020,8417,242587,149,1117,67,0,0,0,6628,359,0,0,186,0,251004,186,0,1
40,6/16/2020,8645,253160,172,1130,75,0,0,0,6765,363,0,0,228,10573,261805,10801,4,13
40,6/17/2020,8904,256528,181,1146,92,0,0,0,6898,364,0,0,259,3368,265432,3627,1,16
40,6/18/2020,9354,260199,197,1146,89,0,0,0,7071,366,0,0,450,3671,269553,4121,2,0
40,6/19/2020,9706,264872,211,1209,96,0,0,0,7212,367,0,0,352,4673,274578,5025,1,63
40,6/20/2020,10037,271925,197,1229,93,0,0,0,7414,368,0,0,331,7053,281962,7384,1,20
40,6/21/2020,10515,271925,197,1243,93,0,0,0,7531,369,0,0,478,0,282440,478,1,14
40,6/22/2020,10733,271925,197,1268,93,0,0,0,7648,369,0,0,218,0,282658,218,0,25
40,6/23/2020,11028,284029,265,1288,111,0,0,0,7888,371,0,0,295,12104,295057,12399,2,20
40,6/24/2020,11510,286768,268,1319,90,0,0,0,8144,372,0,0,482,2739,298278,3221,1,31
40,6/25/2020,11948,293017,277,1336,87,0,0,0,8507,375,0,0,438,6249,304965,6687,3,17
40,6/26/2020,12343,298434,308,1393,126,0,0,0,8817,377,0,0,395,5417,310777,5812,2,57
40,6/27/2020,12642,313021,329,1440,134,0,0,0,9155,384,0,0,299,14587,325663,14886,7,47
40,6/28/2020,12944,313021,329,1456,134,0,0,0,9397,385,0,0,302,0,325965,302,1,16
40,6/29/2020,13172,313021,329,1489,134,0,0,0,9587,385,0,0,228,0,326193,228,0,33
40,6/30/2020,13757,327840,315,1520,111,0,0,0,10085,387,0,0,585,14819,341597,15404,2,31
40,7/1/2020,14112,332201,374,1553,159,0,0,0,10605,389,0,0,355,4361,346313,4716,2,33
40,7/2/2020,14539,338511,368,1615,163,0,0,0,11048,395,0,0,427,6310,353050,6737,6,62
40,7/3/2020,15065,348789,391,1661,165,0,0,0,11519,398,0,0,526,10278,363854,10804,3,46
40,7/4/2020,15645,348789,391,1676,165,0,0,0,11965,398,0,0,580,0,364434,580,0,15
40,7/5/2020,15928,348789,391,1685,165,0,0,0,12246,398,0,0,283,0,364717,283,0,9
40,7/6/2020,16362,348789,391,1689,165,0,0,0,12432,399,0,0,434,0,365151,434,1,4
40,7/7/2020,17220,371798,426,1741,182,0,0,0,13005,404,0,0,858,23009,389018,23867,5,52
40,7/8/2020,17893,376930,458,1804,209,0,0,0,13538,407,0,0,673,5132,394823,5805,3,63
40,7/9/2020,18496,383258,453,1893,215,0,0,0,14100,410,0,0,603,6328,401754,6931,3,89
40,7/10/2020,19092,391982,487,1949,217,0,0,0,14648,416,0,0,596,8724,411074,9320,6,56
40,7/11/2020,19779,400037,499,1992,186,0,0,0,15136,421,0,0,687,8055,419816,8742,5,43
40,7/12/2020,20235,400037,499,2032,186,0,0,0,15485,422,0,0,456,0,420272,456,1,40
40,7/13/2020,20745,400037,499,2063,186,0,0,0,15815,424,0,0,510,0,420782,510,2,31
40,7/14/2020,21738,419556,546,2116,234,0,0,0,16635,428,0,0,993,19519,441294,20512,4,53
40,7/15/2020,22813,424512,561,2170,231,0,0,0,17366,432,0,0,1075,4956,447325,6031,4,54
40,7/16/2020,23441,433376,638,2218,235,0,0,0,18095,438,0,0,628,8864,456817,9492,6,48
40,7/17/2020,24140,440904,604,2289,247,0,0,0,18766,445,0,0,699,7528,465044,8227,7,71
41,3/4/2020,3,29,0,0,0,0,0,0,0,0,0,0,0,0,32,0,0,0
41,3/5/2020,3,45,0,0,0,0,0,0,0,0,0,0,0,16,48,16,0,0
41,3/6/2020,3,64,0,0,0,0,0,0,0,0,0,0,0,19,67,19,0,0
41,3/7/2020,7,77,0,0,0,0,0,0,0,0,0,0,4,13,84,17,0,0
41,3/8/2020,14,100,0,0,0,0,0,0,0,0,0,0,7,23,114,30,0,0
41,3/9/2020,14,165,0,0,0,0,0,0,0,0,0,0,0,65,179,65,0,0
41,3/10/2020,15,213,0,0,0,0,0,0,0,0,0,0,1,48,228,49,0,0
41,3/11/2020,19,286,0,0,0,0,0,0,0,0,0,0,4,73,305,77,0,0
41,3/12/2020,19,286,0,0,0,0,0,0,0,0,0,0,0,0,305,0,0,0
41,3/13/2020,30,337,0,0,0,0,0,0,0,0,0,0,11,51,367,62,0,0
41,3/14/2020,30,337,0,0,0,0,0,0,0,0,0,0,0,0,367,0,0,0
41,3/15/2020,36,420,0,0,0,0,0,0,0,0,0,0,6,83,456,89,0,0
41,3/16/2020,39,579,0,0,0,0,0,0,0,0,0,0,3,159,618,162,0,0
41,3/17/2020,47,689,0,0,0,0,0,0,0,0,0,0,8,110,736,118,0,0
41,3/18/2020,75,1118,0,0,0,0,0,0,0,3,0,0,28,429,1193,457,3,0
41,3/19/2020,88,1329,0,0,0,0,0,0,0,3,0,0,13,211,1417,224,0,0
41,3/20/2020,114,2003,0,0,0,0,0,0,0,3,0,0,26,674,2117,700,0,0
41,3/21/2020,114,2003,0,0,0,0,0,0,0,3,0,0,0,0,2117,0,0,0
41,3/22/2020,161,2864,0,43,0,0,0,0,0,4,0,0,47,861,3025,908,1,43
41,3/23/2020,191,3649,0,56,0,0,0,0,0,5,0,0,30,785,3840,815,1,13
41,3/24/2020,209,4350,0,61,0,0,0,0,0,8,0,0,18,701,4559,719,3,5
41,3/25/2020,209,4350,0,61,0,0,0,0,0,8,0,0,0,0,4559,0,0,0
41,3/26/2020,327,6953,0,90,0,0,0,0,0,11,0,0,118,2603,7280,2721,3,29
41,3/27/2020,414,8510,91,102,0,0,31,0,0,12,0,0,87,1557,8924,1644,1,12
41,3/28/2020,479,9693,107,117,0,0,31,0,0,13,0,0,65,1183,10172,1248,1,15
41,3/29/2020,548,10878,107,129,0,0,37,0,0,13,0,0,69,1185,11426,1254,0,12
41,3/30/2020,606,12277,132,140,0,0,39,0,0,16,0,0,58,1399,12883,1457,3,11
41,3/31/2020,690,13136,132,154,0,0,40,0,0,18,0,0,84,859,13826,943,2,14
41,4/1/2020,736,13136,132,154,0,0,40,0,0,18,0,0,46,0,13872,46,0,0
41,4/2/2020,826,15259,134,188,0,0,38,0,0,21,0,0,90,2123,16085,2213,3,34
41,4/3/2020,899,16535,188,204,0,0,38,0,0,22,0,0,73,1276,17434,1349,1,16
41,4/4/2020,999,16535,0,239,0,0,38,0,0,26,0,0,100,0,17534,100,4,35
41,4/5/2020,1068,19556,0,258,0,0,40,0,0,27,0,0,69,3021,20624,3090,1,19
41,4/6/2020,1132,20669,0,258,0,0,40,0,0,27,0,0,64,1113,21801,1177,0,0
41,4/7/2020,1181,21826,0,324,0,0,69,0,0,33,0,0,49,1157,23007,1206,6,66
41,4/8/2020,1239,23325,156,324,61,0,58,69,0,33,0,0,58,1499,24564,1557,0,0
41,4/9/2020,1321,24306,146,326,66,0,54,0,0,44,0,0,82,981,25627,1063,11,2
41,4/10/2020,1321,24306,146,326,66,0,54,0,0,44,0,0,0,0,25627,0,0,0
41,4/11/2020,1371,25853,140,338,58,0,46,0,0,48,0,0,50,1547,27224,1597,4,12
41,4/12/2020,1527,28231,295,359,81,0,52,0,0,52,0,0,156,2378,29758,2534,4,21
41,4/13/2020,1584,29537,321,369,96,0,50,0,0,53,0,0,57,1306,31121,1363,1,10
41,4/14/2020,1633,30730,311,381,88,0,44,0,0,55,0,0,49,1193,32363,1242,2,12
41,4/15/2020,1663,31688,305,401,95,0,43,0,0,58,0,0,30,958,33351,988,3,20
41,4/16/2020,1736,33202,307,414,89,0,43,0,0,64,0,0,73,1514,34938,1587,6,13
41,4/17/2020,1785,34536,301,427,69,0,41,0,0,70,0,0,49,1334,36321,1383,6,13
41,4/18/2020,1844,35739,290,449,74,0,37,0,0,72,0,0,59,1203,37583,1262,2,22
41,4/19/2020,1910,37128,290,456,74,0,37,0,0,74,0,0,66,1389,39038,1455,2,7
41,4/20/2020,1956,38089,303,465,74,0,35,0,0,75,0,0,46,961,40045,1007,1,9
41,4/21/2020,2002,39126,297,471,70,0,35,0,0,78,0,0,46,1037,41128,1083,3,6
41,4/22/2020,2059,39126,302,488,67,0,35,0,0,78,0,0,57,0,41185,57,0,17
41,4/23/2020,2127,41849,304,512,74,0,36,0,0,83,0,0,68,2723,43976,2791,5,24
41,4/24/2020,2177,43315,258,520,56,0,29,0,0,86,0,0,50,1466,45492,1516,3,8
41,4/25/2020,2253,45124,261,536,60,0,29,0,0,87,0,0,76,1809,47377,1885,1,16
41,4/26/2020,2311,46653,249,546,71,0,31,0,0,91,0,0,58,1529,48964,1587,4,10
41,4/27/2020,2354,48844,249,554,71,0,31,0,0,92,0,0,43,2191,51198,2234,1,8
41,4/28/2020,2354,48844,249,554,71,0,31,0,0,92,0,0,0,0,51198,0,0,0
41,4/29/2020,2446,52026,227,569,56,0,24,0,0,101,0,0,92,3182,54472,3274,9,15
41,4/30/2020,2510,53522,243,578,65,0,28,0,0,103,0,0,64,1496,56032,1560,2,9
41,5/1/2020,2579,55597,208,591,49,0,23,0,0,104,0,0,69,2075,58176,2144,1,13
41,5/2/2020,2635,57501,209,595,50,0,22,0,0,109,0,0,56,1904,60136,1960,5,4
41,5/3/2020,2680,59374,205,598,46,0,21,0,860,109,0,0,45,1873,62054,1918,0,3
41,5/4/2020,2759,60698,207,608,41,0,17,0,860,109,0,0,79,1324,63457,1403,0,10
41,5/5/2020,2839,62585,219,622,49,0,25,0,860,113,0,0,80,1887,65424,1967,4,14
41,5/6/2020,2916,65060,191,641,47,0,20,0,1125,115,0,0,77,2475,67976,2552,2,19
41,5/7/2020,2989,67469,171,645,48,0,23,0,1125,121,0,0,73,2409,70458,2482,6,4
41,5/8/2020,3068,69625,159,659,42,0,18,0,1125,124,0,0,79,2156,72693,2235,3,14
41,5/9/2020,3160,71460,139,662,34,0,19,0,1125,127,0,0,92,1835,74620,1927,3,3
41,5/10/2020,3228,72279,164,670,45,0,22,0,1125,127,0,0,68,819,75507,887,0,8
41,5/11/2020,3286,74320,164,673,40,0,23,0,1125,130,0,0,58,2041,77606,2099,3,3
41,5/12/2020,3286,74320,165,673,39,0,25,0,1125,130,0,0,0,0,77606,0,0,0
41,5/13/2020,3416,80571,162,678,38,0,17,0,1406,134,0,0,130,6251,83987,6381,4,5
41,5/14/2020,3479,80571,163,685,38,0,17,0,1406,137,0,0,63,0,84050,63,3,7
41,5/15/2020,3541,85965,161,691,46,0,19,0,1406,137,0,0,62,5394,89506,5456,0,6
41,5/16/2020,3612,88587,153,699,48,0,16,0,1406,137,0,0,71,2622,92199,2693,0,8
41,5/17/2020,3623,90733,156,703,37,0,16,0,1406,137,0,0,11,2146,94356,2157,0,4
41,5/18/2020,3687,93628,137,708,43,0,13,0,1406,138,0,0,64,2895,97315,2959,1,5
41,5/19/2020,3726,95994,137,714,43,0,13,0,1406,140,0,0,39,2366,99720,2405,2,6
41,5/20/2020,3801,98348,152,723,42,0,17,0,1406,144,0,0,75,2354,102149,2429,4,9
41,5/21/2020,3817,101407,140,732,40,0,14,0,1406,145,0,0,16,3059,105224,3075,1,9
41,5/22/2020,3864,103975,146,737,47,0,16,0,1376,147,0,0,47,2568,107839,2615,2,5
41,5/23/2020,3888,106319,102,740,41,0,15,0,1376,147,0,0,24,2344,110207,2368,0,3
41,5/24/2020,3927,108268,117,742,35,0,18,0,1376,148,0,0,39,1949,112195,1988,1,2
41,5/25/2020,3949,109909,125,747,35,0,23,0,1376,148,0,0,22,1641,113858,1663,0,5
41,5/26/2020,3967,111571,149,752,40,0,17,0,1795,148,0,0,18,1662,115538,1680,0,5
41,5/27/2020,4038,112954,146,759,35,0,16,0,1795,148,0,0,71,1383,116992,1454,0,7
41,5/28/2020,4086,115561,149,768,32,0,17,0,1981,151,0,0,48,2607,119647,2655,3,9
41,5/29/2020,4131,118550,155,771,36,0,21,0,1981,151,0,0,45,2989,122681,3034,0,3
41,5/30/2020,4185,122610,131,778,32,0,17,0,2137,153,0,0,54,4060,126795,4114,2,7
41,5/31/2020,4243,124958,117,786,33,0,17,0,2152,153,0,0,58,2348,129201,2406,0,8
41,6/1/2020,4302,127316,108,790,32,0,17,0,2164,154,0,0,59,2358,131618,2417,1,4
41,6/2/2020,4335,129874,102,795,29,0,15,0,2164,157,0,0,33,2558,134209,2591,3,5
41,6/3/2020,4399,132269,112,800,27,0,10,0,2199,159,0,0,64,2395,136668,2459,2,5
41,6/4/2020,4474,134838,124,812,40,0,13,0,2199,159,0,0,75,2569,139312,2644,0,12
41,6/5/2020,4570,138676,121,819,39,0,16,0,2214,161,0,0,96,3838,143246,3934,2,7
41,6/6/2020,4662,141497,121,819,39,0,16,0,2237,163,0,0,92,2821,146159,2913,2,0
41,6/7/2020,4808,143592,121,819,39,0,16,0,2237,164,0,0,146,2095,148400,2241,1,0
41,6/8/2020,4922,144957,137,843,43,0,18,0,2237,164,0,0,114,1365,149879,1479,0,24
41,6/9/2020,4988,148629,145,851,47,0,20,0,2313,169,0,0,66,3672,153617,3738,5,8
41,6/10/2020,5060,151698,136,857,40,0,18,0,2332,169,0,0,72,3069,156758,3141,0,6
41,6/11/2020,5237,156567,130,864,39,0,19,0,2350,171,0,0,177,4869,161804,5046,2,7
41,6/12/2020,5377,160812,133,875,47,0,15,0,2370,173,0,0,140,4245,166189,4385,2,11
41,6/13/2020,5535,164944,133,875,47,0,15,0,2396,174,0,0,158,4132,170479,4290,1,0
41,6/14/2020,5636,168246,133,875,47,0,15,0,2396,176,0,0,101,3302,173882,3403,2,0
41,6/15/2020,5820,170316,125,899,50,0,19,0,2396,180,0,0,184,2070,176136,2254,4,24
41,6/16/2020,6098,173440,141,912,50,0,22,0,2431,182,0,0,278,3124,179538,3402,2,13
41,6/17/2020,6218,178132,158,929,54,0,26,0,2457,183,0,0,120,4692,184350,4812,1,17
41,6/18/2020,6366,182770,141,933,46,0,28,0,2502,187,0,0,148,4638,189136,4786,4,4
41,6/19/2020,6572,187345,154,946,50,0,29,0,2533,188,0,0,206,4575,193917,4781,1,13
41,6/20/2020,6750,187345,154,946,50,0,29,0,2533,189,0,0,178,0,194095,178,1,0
41,6/21/2020,6937,195674,154,946,50,0,29,0,2533,190,0,0,187,8329,202611,8516,1,0
41,6/22/2020,7083,199545,145,969,48,0,27,0,2588,192,0,0,146,3871,206628,4017,2,23
41,6/23/2020,7274,203438,184,983,58,0,28,0,2604,192,0,0,191,3893,210712,4084,0,14
41,6/24/2020,7444,206564,185,1006,59,0,29,0,2604,195,0,0,170,3126,214008,3296,3,23
41,6/25/2020,7568,209050,189,1012,60,0,29,0,2649,197,0,0,124,2486,216618,2610,2,6
41,6/26/2020,7818,209050,149,1022,53,0,35,0,2649,202,0,0,250,0,216868,250,5,10
41,6/27/2020,8094,219529,149,1022,53,0,35,0,2649,202,0,0,276,10479,227623,10755,0,0
41,6/28/2020,8341,219529,149,1022,53,0,35,0,2649,202,0,0,247,0,227870,247,0,0
41,6/29/2020,8485,226648,151,1025,44,0,25,0,2700,204,0,0,144,7119,235133,7263,2,3
41,6/30/2020,8656,228978,149,1038,42,0,25,0,2722,207,0,0,171,2330,237634,2501,3,13
41,7/1/2020,8931,234429,192,1055,62,0,24,0,2722,208,0,0,275,5451,243360,5726,1,17
41,7/2/2020,9294,241760,173,1069,52,0,25,0,2759,209,0,0,363,7331,251054,7694,1,14
41,7/3/2020,9636,245096,173,1069,52,0,25,0,2759,209,0,0,342,3336,254732,3678,0,0
41,7/4/2020,9930,245096,173,1069,52,0,25,0,2759,213,0,0,294,0,255026,294,4,0
41,7/5/2020,10230,253971,173,1069,52,0,25,0,2759,215,0,0,300,8875,264201,9175,2,0
41,7/6/2020,10395,257326,183,1125,61,0,26,0,2846,215,0,0,165,3355,267721,3520,0,56
41,7/7/2020,10605,261301,191,1141,55,0,22,0,2877,220,0,0,210,3975,271906,4185,5,16
41,7/8/2020,10817,265450,188,1155,57,0,27,0,2877,224,0,0,212,4149,276267,4361,4,14
41,7/9/2020,11188,270887,192,1162,59,0,25,0,2977,230,0,0,371,5437,282075,5808,6,7
41,7/10/2020,11454,275316,208,1180,56,0,30,0,3009,232,0,0,266,4429,286770,4695,2,18
41,7/11/2020,11851,280332,208,1180,56,0,30,0,3009,232,0,0,397,5016,292183,5413,0,0
41,7/12/2020,12170,284002,208,1180,56,0,30,0,3009,234,0,0,319,3670,296172,3989,2,0
41,7/13/2020,12438,288274,246,1234,67,0,35,0,3094,237,0,0,268,4272,300712,4540,3,54
41,7/14/2020,12805,292651,235,1254,64,0,35,0,3129,244,0,0,367,4377,305456,4744,7,20
41,7/15/2020,12805,292651,235,1254,64,0,35,0,3129,244,0,0,0,0,305456,0,0,0
41,7/16/2020,13509,305437,219,1311,63,0,33,0,3199,249,0,0,704,12786,318946,13490,5,57
41,7/17/2020,13802,310393,242,1327,64,0,34,0,3199,254,0,0,293,4956,324195,5249,5,16
42,3/6/2020,2,0,0,0,0,0,0,0,0,0,0,0,0,0,2,0,0,0
42,3/7/2020,4,0,0,0,0,0,0,0,0,0,0,0,2,0,4,2,0,0
42,3/8/2020,6,0,0,0,0,0,0,0,0,0,0,0,2,0,6,2,0,0
42,3/9/2020,10,0,0,0,0,0,0,0,0,0,0,0,4,0,10,4,0,0
42,3/10/2020,12,0,0,0,0,0,0,0,0,0,0,0,2,0,12,2,0,0
42,3/11/2020,16,88,0,0,0,0,0,0,0,0,0,0,4,88,104,92,0,0
42,3/12/2020,22,116,0,0,0,0,0,0,0,0,0,0,6,28,138,34,0,0
42,3/13/2020,41,140,0,0,0,0,0,0,0,0,0,0,19,24,181,43,0,0
42,3/14/2020,47,205,0,0,0,0,0,0,0,0,0,0,6,65,252,71,0,0
42,3/15/2020,63,205,0,0,0,0,0,0,0,0,0,0,16,0,268,16,0,0
42,3/16/2020,76,670,0,0,0,0,0,0,0,0,0,0,13,465,746,478,0,0
42,3/17/2020,96,879,0,0,0,0,0,0,0,0,0,0,20,209,975,229,0,0
42,3/18/2020,133,1187,0,0,0,0,0,0,0,1,0,0,37,308,1320,345,1,0
42,3/19/2020,185,1608,0,0,0,0,0,0,0,1,0,0,52,421,1793,473,0,0
42,3/20/2020,268,2574,0,0,0,0,0,0,0,1,0,0,83,966,2842,1049,0,0
42,3/21/2020,371,3766,0,0,0,0,0,0,0,2,0,0,103,1192,4137,1295,1,0
42,3/22/2020,479,4964,0,0,0,0,0,0,0,2,0,0,108,1198,5443,1306,0,0
42,3/23/2020,644,6595,0,0,0,0,0,0,0,6,0,0,165,1631,7239,1796,4,0
42,3/24/2020,851,8643,0,0,0,0,0,0,0,7,0,0,207,2048,9494,2255,1,0
42,3/25/2020,1127,11193,0,0,0,0,0,0,0,11,0,0,276,2550,12320,2826,4,0
42,3/26/2020,1687,16441,0,0,0,0,0,0,0,16,0,0,560,5248,18128,5808,5,0
42,3/27/2020,2218,21016,0,241,0,0,0,0,0,22,0,0,531,4575,23234,5106,6,241
42,3/28/2020,2751,25254,0,316,0,0,0,0,0,34,0,0,533,4238,28005,4771,12,75
42,3/29/2020,3394,30061,0,353,0,0,0,0,0,38,0,0,643,4807,33455,5450,4,37
42,3/30/2020,4087,33777,0,386,0,0,0,0,0,49,0,0,693,3716,37864,4409,11,33
42,3/31/2020,4843,37645,0,514,0,0,0,0,0,63,0,0,756,3868,42488,4624,14,128
42,4/1/2020,5805,42427,0,620,0,0,0,0,0,74,0,0,962,4782,48232,5744,11,106
42,4/2/2020,7016,47698,0,730,0,0,0,0,0,90,0,0,1211,5271,54714,6482,16,110
42,4/3/2020,8420,53695,0,852,0,0,0,0,0,102,0,0,1404,5997,62115,7401,12,122
42,4/4/2020,10017,60013,0,1004,0,0,0,0,0,136,0,0,1597,6318,70030,7915,34,152
42,4/5/2020,11510,66261,0,1072,0,0,0,0,0,150,0,0,1493,6248,77771,7741,14,68
42,4/6/2020,12980,70874,0,1145,0,0,533,0,0,162,0,0,1470,4613,83854,6083,12,73
42,4/7/2020,14559,76719,1665,0,0,0,548,0,0,240,0,0,1579,5845,91278,7424,78,-1145
42,4/8/2020,16239,82299,1898,0,0,0,603,0,0,309,0,0,1680,5580,98538,7260,69,0
42,4/9/2020,18228,87374,2051,0,0,0,592,0,0,338,0,0,1989,5075,105602,7064,29,0
42,4/10/2020,19979,93040,2072,0,0,0,611,0,0,416,0,0,1751,5666,113019,7417,78,0
42,4/11/2020,21655,98498,2115,0,0,0,639,0,0,494,0,0,1676,5458,120153,7134,78,0
42,4/12/2020,22833,102057,2097,0,0,0,649,0,0,507,0,0,1178,3559,124890,4737,13,0
42,4/13/2020,24199,105593,2243,0,0,0,669,0,0,524,0,0,1366,3536,129792,4902,17,0
42,4/14/2020,25345,108286,2317,0,0,0,675,0,0,584,0,0,1146,2693,133631,3839,60,0
42,4/15/2020,26490,111094,2395,0,0,0,668,0,0,647,0,0,1145,2808,137584,3953,63,0
42,4/16/2020,27735,113735,2512,0,0,0,675,0,0,707,0,0,1245,2641,141470,3886,60,0
42,4/17/2020,29441,117932,2603,0,0,0,661,0,0,756,0,0,1706,4197,147373,5903,49,0
42,4/18/2020,31069,122896,2613,0,0,0,660,0,0,836,0,0,1628,4964,153965,6592,80,0
42,4/19/2020,32284,126570,2634,0,0,0,657,0,0,1112,0,0,1215,3674,158854,4889,276,0
42,4/20/2020,33232,129720,2701,0,0,0,659,0,0,1204,0,0,948,3150,162952,4098,92,0
42,4/21/2020,34528,132323,2743,0,0,0,673,0,0,1564,0,0,1296,2603,166851,3899,360,0
42,4/22/2020,35684,136272,2764,0,0,0,685,0,0,1622,0,0,1156,3949,171956,5105,58,0
42,4/23/2020,37053,142061,2750,0,0,0,679,0,0,1421,0,0,1369,5789,179114,7158,-201,0
42,4/24/2020,38652,147491,2746,0,0,0,679,0,0,1492,0,0,1599,5430,186143,7029,71,0
42,4/25/2020,40049,152886,2748,0,0,0,640,0,0,1537,0,0,1397,5395,192935,6792,45,0
42,4/26/2020,41165,157428,2736,0,0,0,632,0,0,1550,0,0,1116,4542,198593,5658,13,0
42,4/27/2020,42050,161372,2800,0,0,0,629,0,0,1597,0,0,885,3944,203422,4829,47,0
42,4/28/2020,43264,165824,2781,0,0,0,616,0,0,1716,0,0,1214,4452,209088,5666,119,0
42,4/29/2020,44366,170517,2781,0,0,0,602,0,0,2195,0,0,1102,4693,214883,5795,479,0
42,4/30/2020,45763,175602,2707,0,0,0,556,0,0,2292,0,0,1397,5085,221365,6482,97,0
42,5/1/2020,46971,180477,2683,0,0,0,590,0,0,2354,0,0,1208,4875,227448,6083,62,0
42,5/2/2020,48305,187071,2673,0,0,0,571,0,0,2418,0,0,1334,6594,235376,7928,64,0
42,5/3/2020,49267,191374,2645,0,0,0,562,0,0,2444,0,0,962,4303,240641,5265,26,0
42,5/4/2020,50092,195498,2708,0,0,0,573,0,0,2458,0,0,825,4124,245590,4949,14,0
42,5/5/2020,50957,199925,2580,0,0,0,550,0,0,3012,0,0,865,4427,250882,5292,554,0
42,5/6/2020,51845,204495,2545,0,0,0,560,0,0,3106,0,0,888,4570,256340,5458,94,0
42,5/7/2020,52915,209873,2420,0,0,0,539,0,0,3416,0,0,1070,5378,262788,6448,310,0
42,5/8/2020,54238,216321,2342,0,0,0,517,0,0,3616,0,0,1323,6448,270559,7771,200,0
42,5/9/2020,55316,221791,2285,0,0,0,502,0,0,3688,0,0,1078,5470,277107,6548,72,0
42,5/10/2020,56611,227772,2230,0,0,0,501,0,0,3707,0,0,1295,5981,284383,7276,19,0
42,5/11/2020,57154,231704,2176,0,0,0,497,0,0,3731,0,0,543,3932,288858,4475,24,0
42,5/12/2020,57991,237989,2187,0,0,0,497,0,0,3806,0,0,837,6285,295980,7122,75,0
42,5/13/2020,58698,244171,2012,0,0,0,473,0,0,3943,0,0,707,6182,302869,6889,137,0
42,5/14/2020,59636,251559,1983,0,0,0,446,0,0,4218,0,0,938,7388,311195,8326,275,0
42,5/15/2020,60622,259210,1934,0,0,0,431,0,0,4342,0,0,986,7651,319832,8637,124,0
42,5/16/2020,61611,266225,1873,0,0,0,429,0,0,4403,0,0,989,7015,327836,8004,61,0
42,5/17/2020,62234,270670,1821,0,0,0,422,0,0,4418,0,0,623,4445,332904,5068,15,0
42,5/18/2020,63056,277553,1885,0,0,0,397,0,0,4505,0,0,822,6883,340609,7705,87,0
42,5/19/2020,63666,286034,1861,0,0,0,380,0,0,4624,0,0,610,8481,349700,9091,119,0
42,5/20/2020,63666,286034,1818,0,0,0,377,0,0,4624,0,0,0,0,349700,0,0,0
42,5/21/2020,65392,303514,1654,0,0,0,361,0,0,4869,0,0,1726,17480,368906,19206,245,0
42,5/22/2020,66258,312743,1580,0,0,0,368,0,37767,4984,0,0,866,9229,379001,10095,115,0
42,5/23/2020,66983,321469,1560,0,0,0,348,0,39519,5096,0,0,725,8726,388452,9451,112,0
42,5/24/2020,67713,328382,1533,0,0,0,336,0,40627,5124,0,0,730,6913,396095,7643,28,0
42,5/25/2020,68186,334928,1628,0,0,0,324,0,40911,5139,0,0,473,6546,403114,7019,15,0
42,5/26/2020,68637,339835,1493,0,0,0,334,0,41868,5152,0,0,451,4907,408472,5358,13,0
42,5/27/2020,69417,349990,1493,0,0,0,351,0,43038,5265,0,0,780,10155,419407,10935,113,0
42,5/28/2020,70042,357804,1476,0,0,0,321,0,44826,5373,0,0,625,7814,427846,8439,108,0
42,5/29/2020,71339,366970,1445,0,0,0,313,0,46370,5464,0,0,1297,9166,438309,10463,91,0
42,5/30/2020,72031,375741,1352,0,0,0,295,0,47133,5537,0,0,692,8771,447772,9463,73,0
42,5/31/2020,72546,383111,1352,0,0,0,296,0,48190,5555,0,0,515,7370,455657,7885,18,0
42,6/1/2020,72898,389431,1302,0,0,0,287,0,48428,5567,0,0,352,6320,462329,6672,12,0
42,6/2/2020,73510,399361,1302,0,0,0,283,0,48838,5667,0,0,612,9930,472871,10542,100,0
42,6/3/2020,74022,401369,1164,0,0,0,269,0,49915,5741,0,0,512,2008,475391,2520,74,0
42,6/4/2020,74560,416942,1174,0,0,0,268,0,51019,5817,0,0,538,15573,491502,16111,76,0
42,6/5/2020,75005,424201,1174,0,0,0,268,0,52069,5886,0,0,445,7259,499206,7704,69,0
42,6/6/2020,75706,435122,1174,0,0,0,268,0,52560,5931,0,0,701,10921,510828,11622,45,0
42,6/7/2020,76212,444173,1174,0,0,0,268,0,53670,5943,0,0,506,9051,520385,9557,12,0
42,6/8/2020,76563,451387,1174,0,0,0,268,0,53670,5953,0,0,351,7214,527950,7565,10,0
42,6/9/2020,77056,459248,1032,0,0,0,237,0,53670,6014,0,0,493,7861,536304,8354,61,0
42,6/10/2020,77466,466964,992,0,0,0,218,0,54560,6062,0,0,410,7716,544430,8126,48,0
42,6/11/2020,77933,476439,946,0,0,0,215,0,55665,6113,0,0,467,9475,554372,9942,51,0
42,6/12/2020,77999,488385,899,0,0,0,202,0,56939,6162,0,0,66,11946,566384,12012,49,0
42,6/13/2020,78462,496589,875,0,0,0,192,0,58061,6211,0,0,463,8204,575051,8667,49,0
42,6/14/2020,78798,504435,852,0,0,0,189,0,58310,6215,0,0,336,7846,583233,8182,4,0
42,6/15/2020,79121,513909,851,0,0,0,178,0,58549,6243,0,0,323,9474,593030,9797,28,0
42,6/16/2020,79483,523609,800,0,0,0,179,0,59612,6276,0,0,362,9700,603092,10062,33,0
42,6/17/2020,79818,533013,788,0,0,0,179,0,59863,6319,0,0,335,9404,612831,9739,43,0
42,6/18/2020,80236,543832,740,0,0,0,170,0,60979,6361,0,0,418,10819,624068,11237,42,0
42,6/19/2020,80762,556456,731,0,0,0,169,0,62186,6399,0,0,526,12624,637218,13150,38,0
42,6/20/2020,81266,566461,715,0,0,0,161,0,62574,6419,0,0,504,10005,647727,10509,20,0
42,6/21/2020,81730,576015,735,0,0,0,157,0,62932,6423,0,0,464,9554,657745,10018,4,0
42,6/22/2020,82186,585662,745,0,0,0,156,0,64105,6426,0,0,456,9647,667848,10103,3,0
42,6/23/2020,82696,596407,738,0,0,0,151,0,64502,6464,0,0,510,10745,679103,11255,38,0
42,6/24/2020,83191,608217,707,0,0,0,136,0,64502,6518,0,0,495,11810,691408,12305,54,0
42,6/25/2020,83770,621031,704,0,0,0,142,0,65340,6557,0,0,579,12814,704801,13393,39,0
42,6/26/2020,84370,634711,661,0,0,0,131,0,65808,6579,0,0,600,13680,719081,14280,22,0
42,6/27/2020,84370,634711,651,0,0,0,126,0,65808,6579,0,0,0,0,719081,0,0,0
42,6/28/2020,85496,657486,648,0,0,0,121,0,66686,6579,0,0,1126,22775,742982,23901,0,0
42,6/29/2020,85988,666901,635,0,0,0,111,0,67070,6614,0,0,492,9415,752889,9907,35,0
42,6/30/2020,86606,677581,634,0,0,0,110,0,67552,6649,0,0,618,10680,764187,11298,35,0
42,7/1/2020,87242,689562,632,0,0,0,111,0,68048,6649,0,0,636,11981,776804,12617,0,0
42,7/2/2020,88074,702199,631,0,0,0,106,0,68697,6712,0,0,832,12637,790273,13469,63,0
42,7/3/2020,88741,715403,598,0,0,0,105,0,69217,6746,0,0,667,13204,804144,13871,34,0
42,7/4/2020,89375,725448,589,0,0,0,102,0,69712,6749,0,0,634,10045,814823,10679,3,0
42,7/5/2020,89854,734846,592,0,0,0,106,0,70086,6753,0,0,479,9398,824700,9877,4,0
42,7/6/2020,90304,743020,598,0,0,0,107,0,70437,6754,0,0,450,8174,833324,8624,1,0
42,7/7/2020,91299,758803,637,0,0,0,101,0,70437,6787,0,0,995,15783,850102,16778,33,0
42,7/8/2020,92148,774378,649,0,0,0,104,0,70953,6812,0,0,849,15575,866526,16424,25,0
42,7/9/2020,92867,787156,650,0,0,0,102,0,71507,6848,0,0,719,12778,880023,13497,36,0
42,7/10/2020,93876,804764,653,0,0,0,103,0,72284,6880,0,0,1009,17608,898640,18617,32,0
42,7/11/2020,94689,817634,646,0,0,0,97,0,72910,6897,0,0,813,12870,912323,13683,17,0
42,7/12/2020,95266,829018,652,0,0,0,96,0,73354,6904,0,0,577,11384,924284,11961,7,0
42,7/13/2020,95742,835732,682,0,0,0,96,0,73721,6911,0,0,476,6714,931474,7190,7,0
42,7/14/2020,96671,850612,678,0,0,0,95,0,74436,6931,0,0,929,14880,947283,15809,20,0
42,7/15/2020,97665,870984,667,0,0,0,92,0,74436,6957,0,0,994,20372,968649,21366,26,0
42,7/16/2020,98446,885195,652,0,0,0,95,0,74818,6973,0,0,781,14211,983641,14992,16,0
42,7/17/2020,99478,899912,680,0,0,0,98,0,75603,6992,0,0,1032,14717,999390,15749,19,0
44,3/1/2020,2,2,0,0,0,0,0,0,0,0,0,0,0,0,4,0,0,0
44,3/2/2020,2,3,0,0,0,0,0,0,0,0,0,0,0,1,5,1,0,0
44,3/3/2020,2,5,0,0,0,0,0,0,0,0,0,0,0,2,7,2,0,0
44,3/4/2020,2,15,0,0,0,0,0,0,0,0,0,0,0,10,17,10,0,0
44,3/5/2020,3,19,0,0,0,0,0,0,0,0,0,0,1,4,22,5,0,0
44,3/6/2020,3,30,0,0,0,0,0,0,0,0,0,0,0,11,33,11,0,0
44,3/7/2020,3,49,0,0,0,0,0,0,0,0,0,0,0,19,52,19,0,0
44,3/8/2020,3,67,0,0,0,0,0,0,0,0,0,0,0,18,70,18,0,0
44,3/9/2020,4,82,0,0,0,0,0,0,0,0,0,0,1,15,86,16,0,0
44,3/10/2020,5,105,0,0,0,0,0,0,0,0,0,0,1,23,110,24,0,0
44,3/11/2020,5,139,0,0,0,0,0,0,0,0,0,0,0,34,144,34,0,0
44,3/12/2020,13,176,0,0,0,0,0,0,0,0,0,0,8,37,189,45,0,0
44,3/13/2020,19,224,0,0,0,0,0,0,0,0,0,0,6,48,243,54,0,0
44,3/14/2020,19,310,0,0,0,0,0,0,0,0,0,0,0,86,329,86,0,0
44,3/15/2020,20,364,0,0,0,0,0,0,0,0,0,0,1,54,384,55,0,0
44,3/16/2020,22,455,0,0,0,0,0,0,0,0,0,0,2,91,477,93,0,0
44,3/17/2020,33,608,0,0,0,0,0,0,0,0,0,0,11,153,641,164,0,0
44,3/18/2020,44,719,0,0,0,0,0,0,0,0,0,0,11,111,763,122,0,0
44,3/19/2020,61,968,0,0,0,0,0,0,0,0,0,0,17,249,1029,266,0,0
44,3/20/2020,74,1161,0,0,0,0,0,0,0,0,0,0,13,193,1235,206,0,0
44,3/21/2020,88,1284,0,0,0,0,0,0,0,0,0,0,14,123,1372,137,0,0
44,3/22/2020,113,1547,0,0,0,0,0,0,0,0,0,0,25,263,1660,288,0,0
44,3/23/2020,129,1713,0,0,0,0,0,0,0,0,0,0,16,166,1842,182,0,0
44,3/24/2020,148,1951,0,0,0,0,0,0,0,0,0,0,19,238,2099,257,0,0
44,3/25/2020,176,2124,15,0,0,0,0,0,0,0,0,0,28,173,2300,201,0,0
44,3/26/2020,217,2300,23,0,9,0,6,0,0,0,0,0,41,176,2517,217,0,0
44,3/27/2020,248,2502,28,0,9,0,6,0,0,0,0,0,31,202,2750,233,0,0
44,3/28/2020,312,2742,29,0,9,0,6,0,0,0,0,0,64,240,3054,304,0,0
44,3/29/2020,417,3056,35,0,9,0,6,0,0,3,0,0,105,314,3473,419,3,0
44,3/30/2020,495,3246,41,0,9,0,6,0,0,4,0,0,78,190,3741,268,1,0
44,3/31/2020,568,3544,59,0,9,0,6,0,35,8,0,0,73,298,4112,371,4,0
44,4/1/2020,668,4189,60,0,14,0,6,0,35,10,0,0,100,645,4857,745,2,0
44,4/2/2020,730,4625,72,0,14,0,6,0,35,12,0,0,62,436,5355,498,2,0
44,4/3/2020,831,5342,77,0,14,0,6,0,35,14,0,0,101,717,6173,818,2,0
44,4/4/2020,968,5962,93,0,31,0,6,0,35,17,0,0,137,620,6930,757,3,0
44,4/5/2020,1150,7032,103,0,33,0,6,0,35,25,0,0,182,1070,8182,1252,8,0
44,4/6/2020,1356,8609,109,0,37,0,26,0,35,27,0,0,206,1577,9965,1783,2,0
44,4/7/2020,1617,10095,123,0,40,0,26,0,35,30,0,0,261,1486,11712,1747,3,0
44,4/8/2020,1890,11667,143,0,45,0,26,0,35,35,0,0,273,1572,13557,1845,5,0
44,4/9/2020,2169,13029,160,0,45,0,26,0,35,43,0,0,279,1362,15198,1641,8,0
44,4/10/2020,2573,15403,169,0,45,0,26,0,35,49,0,0,404,2374,17976,2778,6,0
44,4/11/2020,2853,17130,183,0,50,0,26,0,35,56,0,0,280,1727,19983,2007,7,0
44,4/12/2020,3142,18578,201,0,50,0,26,0,35,63,0,0,289,1448,21720,1737,7,0
44,4/13/2020,3329,19431,197,331,50,0,26,0,135,73,0,0,187,853,22760,1040,10,331
44,4/14/2020,3596,20990,213,331,48,0,0,0,135,80,0,0,267,1559,24586,1826,7,0
44,4/15/2020,3903,22567,229,331,54,0,44,0,168,87,0,0,307,1577,26470,1884,7,0
44,4/16/2020,4295,24657,245,331,61,0,43,0,182,105,0,0,392,2090,28952,2482,18,0
44,4/17/2020,4585,26157,252,331,62,0,43,0,196,118,0,0,290,1500,30742,1790,13,0
44,4/18/2020,4868,27527,293,578,67,0,43,0,217,150,0,0,283,1370,32395,1653,32,247
44,4/19/2020,5207,29289,298,605,66,0,37,0,244,164,0,0,339,1762,34496,2101,14,27
44,4/20/2020,5585,30883,297,629,62,0,45,0,267,175,0,0,378,1594,36468,1972,11,24
44,4/21/2020,5972,32606,309,674,67,0,43,0,315,186,0,0,387,1723,38578,2110,11,45
44,4/22/2020,6354,34528,314,717,71,0,44,0,315,201,0,0,382,1922,40882,2304,15,43
44,4/23/2020,6773,36423,316,757,72,0,45,0,342,213,0,0,419,1895,43196,2314,12,40
44,4/24/2020,7188,39071,267,576,77,0,48,0,377,202,0,0,415,2648,46259,3063,-11,-181
44,4/25/2020,7493,40860,263,576,77,0,52,0,410,215,0,0,305,1789,48353,2094,13,0
44,4/26/2020,7769,42746,258,691,78,0,53,0,433,226,0,0,276,1886,50515,2162,11,115
44,4/27/2020,7972,43915,266,718,81,0,56,0,452,233,0,0,203,1169,51887,1372,7,27
44,4/28/2020,8296,45689,266,732,84,0,55,0,466,239,0,0,324,1774,53985,2098,6,14
44,4/29/2020,8668,48143,269,750,80,0,55,0,391,251,0,0,372,2454,56811,2826,12,18
44,4/30/2020,9016,50100,339,896,85,0,54,0,461,266,0,0,348,1957,59116,2305,15,146
44,5/1/2020,9333,52328,352,937,76,0,51,0,485,279,0,0,317,2228,61661,2545,13,41
44,5/2/2020,9522,53623,333,977,80,0,54,0,531,296,0,0,189,1295,63145,1484,17,40
44,5/3/2020,9703,55233,330,1013,83,0,59,0,565,320,0,0,181,1610,64936,1791,24,36
44,5/4/2020,9994,56802,339,1061,84,0,61,0,601,341,0,0,291,1569,66796,1860,21,48
44,5/5/2020,10297,58781,327,1092,89,0,62,0,639,355,0,0,303,1979,69078,2282,14,31
44,5/6/2020,10639,60718,324,1123,86,0,60,0,665,370,0,0,342,1937,71357,2279,15,31
44,5/7/2020,10910,62647,318,1153,82,0,56,0,696,388,0,0,271,1929,73557,2200,18,30
44,5/8/2020,11141,64338,312,1187,71,0,52,0,730,399,0,0,231,1691,75479,1922,11,34
44,5/9/2020,11427,66604,292,1218,77,0,56,0,772,418,0,0,286,2266,78031,2552,19,31
44,5/10/2020,11613,68106,283,1251,70,0,52,0,809,422,0,0,186,1502,79719,1688,4,33
44,5/11/2020,11788,69365,276,1280,73,0,52,0,841,430,0,0,175,1259,81153,1434,8,29
44,5/12/2020,12007,70916,277,1307,72,0,53,0,863,444,0,0,219,1551,82923,1770,14,27
44,5/13/2020,12203,72840,269,1328,68,0,48,0,886,462,0,0,196,1924,85043,2120,18,21
44,5/14/2020,12431,74767,271,1351,65,0,42,0,903,468,0,0,228,1927,87198,2155,6,23
44,5/15/2020,12663,76467,272,1372,63,0,41,0,919,479,0,0,232,1700,89130,1932,11,21
44,5/16/2020,12915,78231,273,1403,66,0,44,0,947,489,0,0,252,1764,91146,2016,10,31
44,5/17/2020,13040,79768,260,1418,64,0,45,0,972,499,0,0,125,1537,92808,1662,10,15
44,5/18/2020,13177,81057,236,1438,62,0,46,0,1012,506,0,0,137,1289,94234,1426,7,20
44,5/19/2020,13392,82935,247,1464,59,0,44,0,1023,532,0,0,215,1878,96327,2093,26,26
44,5/20/2020,13579,84460,257,1486,58,0,45,0,1030,538,0,0,187,1525,98039,1712,6,22
44,5/21/2020,13748,86399,254,1506,56,0,41,0,1047,556,0,0,169,1939,100147,2108,18,20
44,5/22/2020,13949,87850,242,1537,56,0,40,0,1084,579,0,0,201,1451,101799,1652,23,31
44,5/23/2020,14057,89167,233,1557,51,0,34,0,1106,597,0,0,108,1317,103224,1425,18,20
44,5/24/2020,14141,89924,240,1580,49,0,32,0,1119,608,0,0,84,757,104065,841,11,23
44,5/25/2020,14211,90674,240,1580,49,0,32,0,1119,608,0,0,70,750,104885,820,0,0
44,5/26/2020,14365,92400,226,1613,50,0,36,0,1158,634,0,0,154,1726,106765,1880,26,33
44,5/27/2020,14498,93504,218,1624,49,0,35,0,1175,655,0,0,133,1104,108002,1237,21,11
44,5/28/2020,14630,94575,222,1639,53,0,36,0,1186,677,0,0,132,1071,109205,1203,22,15
44,5/29/2020,14808,96112,219,1660,47,0,33,0,1206,693,0,0,178,1537,110920,1715,16,21
44,5/30/2020,14912,97940,219,1682,50,0,32,0,1225,711,0,0,104,1828,112852,1932,18,22
44,5/31/2020,14988,98790,206,1701,46,0,29,0,1252,718,0,0,76,850,113778,926,7,19
44,6/1/2020,15087,100112,195,1724,46,0,29,0,1281,720,0,0,99,1322,115199,1421,2,23
44,6/2/2020,15194,101512,188,1743,48,0,31,0,1302,732,0,0,107,1400,116706,1507,12,19
44,6/3/2020,15299,103136,189,1753,44,0,30,0,1311,742,0,0,105,1624,118435,1729,10,10
44,6/4/2020,15416,105136,185,1765,42,0,29,0,1326,756,0,0,117,2000,120552,2117,14,12
44,6/5/2020,15521,106656,182,1775,37,0,23,0,1336,772,0,0,105,1520,122177,1625,16,10
44,6/6/2020,15589,107782,182,1775,37,0,23,0,1336,772,0,0,68,1126,123371,1194,0,0
44,6/7/2020,15638,108540,182,1775,37,0,23,0,1336,772,0,0,49,758,124178,807,0,0
44,6/8/2020,15683,109424,146,1807,28,0,20,0,1390,799,0,0,45,884,125107,929,27,32
44,6/9/2020,15751,110588,144,1815,31,0,19,0,1398,808,0,0,68,1164,126339,1232,9,8
44,6/10/2020,15855,111952,148,1828,27,0,16,0,1406,812,0,0,104,1364,127807,1468,4,13
44,6/11/2020,15942,113390,146,1842,26,0,16,0,1419,823,0,0,87,1438,129332,1525,11,14
44,6/12/2020,16023,115483,141,1853,28,0,17,0,1435,833,0,0,81,2093,131506,2174,10,11
44,6/13/2020,16072,116709,141,1853,28,0,17,0,1435,833,0,0,49,1226,132781,1275,0,0
44,6/14/2020,16104,117593,141,1853,28,0,17,0,1435,833,0,0,32,884,133697,916,0,0
44,6/15/2020,16180,119304,127,1882,21,0,14,0,1474,851,0,0,76,1711,135484,1787,18,29
44,6/16/2020,16232,120790,129,1889,16,0,13,0,1479,865,0,0,52,1486,137022,1538,14,7
44,6/17/2020,16283,121997,126,1898,17,0,13,0,1489,876,0,0,51,1207,138280,1258,11,9
44,6/18/2020,16354,123216,126,1911,23,0,13,0,1502,885,0,0,71,1219,139570,1290,9,13
44,6/19/2020,16413,124397,123,1922,23,0,12,0,1515,894,0,0,59,1181,140810,1240,9,11
44,6/20/2020,16449,125078,123,1922,23,0,12,0,1515,894,0,0,36,681,141527,717,0,0
44,6/21/2020,16476,125701,123,1922,23,0,12,0,1515,894,0,0,27,623,142177,650,0,0
44,6/22/2020,16535,127297,106,1950,18,0,15,0,1554,903,0,0,59,1596,143832,1655,9,28
44,6/23/2020,16612,128896,105,1958,19,0,17,0,1562,906,0,0,77,1599,145508,1676,3,8
44,6/24/2020,16663,130382,104,1967,20,0,16,0,1573,912,0,0,51,1486,147045,1537,6,9
44,6/25/2020,16708,131788,103,1981,18,0,17,0,1588,920,0,0,45,1406,148496,1451,8,14
44,6/26/2020,16777,133102,91,1984,16,0,15,0,1600,927,0,0,69,1314,149879,1383,7,3
44,6/27/2020,16813,134300,91,1984,16,0,15,0,1600,927,0,0,36,1198,151113,1234,0,0
44,6/28/2020,16835,134878,91,1984,16,0,15,0,1600,927,0,0,22,578,151713,600,0,0
44,6/29/2020,16871,136198,73,1995,15,0,14,0,1627,946,0,0,36,1320,153069,1356,19,11
44,6/30/2020,16911,137172,74,2001,13,0,13,0,1631,950,0,0,40,974,154083,1014,4,6
44,7/1/2020,16976,139063,69,2007,11,0,11,0,1638,956,0,0,65,1891,156039,1956,6,6
44,7/2/2020,17035,140048,67,2011,11,0,10,0,1644,959,0,0,59,985,157083,1044,3,4
44,7/3/2020,17057,140721,61,2019,9,0,7,0,1657,960,0,0,22,673,157778,695,1,8
44,7/4/2020,17084,141673,61,2019,9,0,7,0,1657,960,0,0,27,952,158757,979,0,0
44,7/5/2020,17108,143047,61,2019,9,0,7,0,1657,960,0,0,24,1374,160155,1398,0,0
44,7/6/2020,17163,144551,61,2019,9,0,7,0,1657,960,0,0,55,1504,161714,1559,0,0
44,7/7/2020,17204,146066,55,2036,4,0,4,0,1677,969,0,0,41,1515,163270,1556,9,17
44,7/8/2020,17204,146066,56,2043,5,0,5,0,1683,971,0,0,0,0,163270,0,2,7
44,7/9/2020,17243,147894,55,2043,4,0,3,0,1684,974,0,0,39,1828,165137,1867,3,0
44,7/10/2020,17312,149343,61,2051,4,0,5,0,1685,976,0,0,69,1449,166655,1518,2,8
44,7/11/2020,17312,149343,61,2051,4,0,5,0,1685,976,0,0,0,0,166655,0,0,0
44,7/12/2020,17312,149343,61,2051,4,0,5,0,1685,976,0,0,0,0,166655,0,0,0
44,7/13/2020,17487,155756,67,2066,3,0,4,0,1691,984,0,0,175,6413,173243,6588,8,15
44,7/14/2020,17588,157070,69,2070,5,0,3,0,1692,985,0,0,101,1314,174658,1415,1,4
44,7/15/2020,17640,158235,59,2075,5,0,3,0,1707,987,0,0,52,1165,175875,1217,2,5
44,7/16/2020,17711,159677,64,2084,4,0,3,0,1711,988,0,0,71,1442,177388,1513,1,9
44,7/17/2020,17793,161408,62,2088,4,0,2,0,1717,990,0,0,82,1731,179201,1813,2,4
45,3/4/2020,0,5,0,0,0,0,0,0,0,0,0,0,0,0,5,0,0,0
45,3/5/2020,0,5,0,0,0,0,0,0,0,0,0,0,0,0,5,0,0,0
45,3/6/2020,0,5,0,0,0,0,0,0,0,0,0,0,0,0,5,0,0,0
45,3/7/2020,2,8,0,0,0,0,0,0,0,0,0,0,2,3,10,5,0,0
45,3/8/2020,2,8,0,0,0,0,0,0,0,0,0,0,0,0,10,0,0,0
45,3/9/2020,7,24,0,0,0,0,0,0,0,0,0,0,5,16,31,21,0,0
45,3/10/2020,7,24,0,0,0,0,0,0,0,0,0,0,0,0,31,0,0,0
45,3/11/2020,9,32,0,0,0,0,0,0,0,0,0,0,2,8,41,10,0,0
45,3/12/2020,10,48,0,0,0,0,0,0,0,0,0,0,1,16,58,17,0,0
45,3/13/2020,12,75,0,0,0,0,0,0,0,0,0,0,2,27,87,29,0,0
45,3/14/2020,13,110,0,0,0,0,0,0,0,0,0,0,1,35,123,36,0,0
45,3/15/2020,19,154,0,0,0,0,0,0,0,0,0,0,6,44,173,50,0,0
45,3/16/2020,28,235,0,0,0,0,0,0,0,1,0,0,9,81,263,90,1,0
45,3/17/2020,33,311,0,0,0,0,0,0,0,1,0,0,5,76,344,81,0,0
45,3/18/2020,60,583,0,0,0,0,0,0,0,1,0,0,27,272,643,299,0,0
45,3/19/2020,60,583,0,0,0,0,0,0,0,1,0,0,0,0,643,0,0,0
45,3/20/2020,81,833,0,0,0,0,0,0,0,1,0,0,21,250,914,271,0,0
45,3/21/2020,152,1255,0,0,0,0,0,0,0,1,0,0,71,422,1407,493,0,0
45,3/22/2020,195,1466,0,0,0,0,0,0,0,3,0,0,43,211,1661,254,2,0
45,3/23/2020,298,1466,0,0,0,0,0,0,0,5,0,0,103,0,1764,103,2,0
45,3/24/2020,298,2012,0,0,0,0,0,0,0,5,0,0,0,546,2310,546,0,0
45,3/25/2020,424,2303,0,102,0,0,0,0,0,7,0,0,126,291,2727,417,2,102
45,3/26/2020,456,2307,0,102,0,0,0,0,0,9,0,0,32,4,2763,36,2,0
45,3/27/2020,456,2307,0,102,0,0,0,0,0,9,0,0,0,0,2763,0,0,0
45,3/28/2020,539,2408,0,102,0,0,0,0,0,13,0,0,83,101,2947,184,4,0
45,3/29/2020,774,3015,0,102,0,0,0,0,0,16,0,0,235,607,3789,842,3,0
45,3/30/2020,925,4160,0,102,0,0,0,0,0,18,0,0,151,1145,5085,1296,2,0
45,3/31/2020,1083,4616,0,102,0,0,0,0,0,22,0,0,158,456,5699,614,4,0
45,4/1/2020,1293,5033,0,102,0,0,0,0,0,26,0,0,210,417,6326,627,4,0
45,4/2/2020,1554,5441,0,241,0,0,0,0,0,31,0,0,261,408,6995,669,5,139
45,4/3/2020,1554,5441,0,241,0,0,0,0,0,31,0,0,0,0,6995,0,0,0
45,4/4/2020,1917,16397,0,241,0,0,0,0,0,40,0,0,363,10956,18314,11319,9,0
45,4/5/2020,2049,16927,0,241,0,0,0,0,0,44,0,0,132,530,18976,662,4,0
45,4/6/2020,2049,16927,0,241,0,0,0,0,0,44,0,0,0,0,18976,0,0,0
45,4/7/2020,2417,21263,0,241,0,0,0,0,0,51,0,0,368,4336,23680,4704,7,0
45,4/8/2020,2552,22082,0,241,0,0,0,0,0,63,0,0,135,819,24634,954,12,0
45,4/9/2020,2792,24575,0,241,0,0,0,0,0,67,0,0,240,2493,27367,2733,4,0
45,4/10/2020,3065,25118,0,496,0,0,0,0,0,72,0,0,273,543,28183,816,5,255
45,4/11/2020,3207,26886,0,496,0,0,0,0,0,80,0,0,142,1768,30093,1910,8,0
45,4/12/2020,3319,28106,0,496,0,0,0,0,0,82,0,0,112,1220,31425,1332,2,0
45,4/13/2020,3319,28106,0,496,0,0,0,0,0,82,0,0,0,0,31425,0,0,0
45,4/14/2020,3553,30319,0,675,0,0,0,0,0,97,0,0,234,2213,33872,2447,15,179
45,4/15/2020,3656,31077,0,675,0,0,0,0,0,107,0,0,103,758,34733,861,10,0
45,4/16/2020,3656,31077,0,675,0,0,0,0,0,107,0,0,0,0,34733,0,0,0
45,4/17/2020,3931,32353,0,675,0,0,0,0,0,109,0,0,275,1276,36284,1551,2,0
45,4/18/2020,4246,34587,0,776,0,0,0,0,2633,119,0,0,315,2234,38833,2549,10,101
45,4/19/2020,4377,36103,0,776,0,0,0,0,2633,120,0,0,131,1516,40480,1647,1,0
45,4/20/2020,4377,36103,0,776,0,0,0,0,2063,120,0,0,0,0,40480,0,0,0
45,4/21/2020,4439,36838,0,776,0,0,0,0,2063,124,0,0,62,735,41277,797,4,0
45,4/22/2020,4761,38350,0,837,0,0,0,0,3317,140,0,0,322,1512,43111,1834,16,61
45,4/23/2020,4917,39546,0,837,0,0,0,0,3317,150,0,0,156,1196,44463,1352,10,0
45,4/24/2020,4917,39546,0,837,0,0,0,0,3317,150,0,0,0,0,44463,0,0,0
45,4/25/2020,5253,43761,0,944,0,0,0,0,3701,166,0,0,336,4215,49014,4551,16,107
45,4/26/2020,5490,45271,0,944,0,0,0,0,3701,174,0,0,237,1510,50761,1747,8,0
45,4/27/2020,5490,45271,0,944,0,0,0,0,3701,174,0,0,0,0,50761,0,0,0
45,4/28/2020,5613,46532,0,944,0,0,0,0,2830,177,0,0,123,1261,52145,1384,3,0
45,4/29/2020,5881,48336,0,1000,0,0,0,0,3252,203,0,0,268,1804,54217,2072,26,56
45,4/30/2020,6095,50417,0,1000,0,0,0,0,3252,244,0,0,214,2081,56512,2295,41,0
45,5/1/2020,6258,53121,0,1110,0,0,0,0,3622,256,0,0,163,2704,59379,2867,12,110
45,5/2/2020,6489,55127,0,1110,0,0,0,0,3622,267,0,0,231,2006,61616,2237,11,0
45,5/3/2020,6626,57562,0,1110,0,0,0,0,3622,275,0,0,137,2435,64188,2572,8,0
45,5/4/2020,6626,57562,0,1110,0,0,0,0,3622,275,0,0,0,0,64188,0,0,0
45,5/5/2020,6757,61014,0,1110,0,0,0,0,3622,283,0,0,131,3452,67771,3583,8,0
45,5/6/2020,6936,70546,0,1152,0,0,0,0,3816,305,0,0,179,9532,77482,9711,22,42
45,5/7/2020,6936,70546,0,1152,0,0,0,0,3816,305,0,0,0,0,77482,0,0,0
45,5/8/2020,7142,66300,0,1152,0,0,0,0,3816,316,0,0,206,-4246,73442,-4040,11,0
45,5/9/2020,7531,73432,0,1252,0,0,0,0,4120,330,0,0,389,7132,80963,7521,14,100
45,5/10/2020,7653,76804,0,1252,0,0,0,0,4120,331,0,0,122,3372,84457,3494,1,0
45,5/11/2020,7653,76804,0,1252,0,0,0,0,4120,331,0,0,0,0,84457,0,0,0
45,5/12/2020,7927,85213,0,1338,0,0,0,0,6817,355,355,0,274,8409,93140,8683,24,86
45,5/13/2020,7927,85213,0,1338,0,0,0,0,6817,355,355,0,0,0,93140,0,0,0
45,5/14/2020,8189,94346,0,1338,0,0,0,0,4914,371,371,0,262,9133,102535,9395,16,0
45,5/15/2020,8407,101209,0,1421,0,0,0,0,5076,380,380,0,218,6863,109616,7081,9,83
45,5/16/2020,8407,101209,0,1421,0,0,0,0,5076,380,380,0,0,0,109616,0,0,0
45,5/17/2020,8816,111670,0,1421,0,0,0,0,5076,380,380,0,409,10461,120486,10870,0,0
45,5/18/2020,8942,122617,0,1421,0,0,0,0,5076,391,391,0,126,10947,131559,11073,11,0
45,5/19/2020,9056,126007,0,1444,0,0,0,0,5451,399,399,0,114,3390,135063,3504,8,23
45,5/20/2020,9056,126007,0,1444,0,0,0,0,5451,399,399,0,0,0,135063,0,0,0
45,5/21/2020,9175,129063,414,1444,0,0,0,0,5451,407,407,0,119,3056,138238,3175,8,0
45,5/22/2020,9638,140385,429,1534,0,0,0,0,5743,419,419,0,463,11322,150023,11785,12,90
45,5/23/2020,9895,149015,430,1534,0,0,0,0,5743,425,425,0,257,8630,158910,8887,6,0
45,5/24/2020,10096,153851,461,1534,0,0,0,0,5743,435,435,0,201,4836,163947,5037,10,0
45,5/25/2020,10178,155842,407,1534,0,0,0,0,6063,440,440,0,82,1991,166020,2073,5,0
45,5/26/2020,10416,162318,433,1618,0,0,0,0,6102,446,446,0,238,6476,172734,6714,6,84
45,5/27/2020,10623,165060,398,1618,0,0,0,0,6102,466,466,0,207,2742,175683,2949,20,0
45,5/28/2020,10788,171461,397,1618,0,0,0,0,6102,470,470,0,165,6401,182249,6566,4,0
45,5/29/2020,11131,177126,399,1634,0,0,0,0,6459,483,483,0,343,5665,188257,6008,13,16
45,5/30/2020,11394,178125,387,1634,0,0,0,0,6459,487,487,0,263,999,189519,1262,4,0
45,5/31/2020,11861,188355,402,1634,0,0,0,0,6459,494,494,0,467,10230,200216,10697,7,0
45,6/1/2020,12148,192540,450,1634,0,0,0,0,6459,500,500,0,287,4185,204688,4472,6,0
45,6/2/2020,12415,206362,425,1789,0,0,0,0,6976,501,501,0,267,13822,218777,14089,1,155
45,6/3/2020,12651,210274,433,1789,0,0,0,0,6976,518,518,0,236,3912,222925,4148,17,0
45,6/4/2020,13005,217846,453,1789,0,0,0,0,6976,525,525,0,354,7572,230851,7926,7,0
45,6/5/2020,13453,217846,453,1814,0,0,0,0,7347,538,538,0,448,0,231299,448,13,25
45,6/6/2020,13916,218828,453,1814,0,0,0,0,7347,545,545,0,463,982,232744,1445,7,0
45,6/7/2020,14286,223573,477,1814,0,0,0,0,7347,546,546,0,370,4745,237859,5115,1,0
45,6/8/2020,14800,229861,507,1814,0,0,0,0,7347,557,557,0,514,6288,244661,6802,11,0
45,6/9/2020,15228,232754,541,1898,0,0,0,0,7928,568,568,0,428,2893,247982,3321,11,84
45,6/10/2020,15759,236773,513,1898,0,0,0,0,7928,575,575,0,531,4019,252532,4550,7,0
45,6/11/2020,16441,213616,494,1898,0,0,0,0,7928,588,588,0,682,-23157,230057,-22475,13,0
45,6/12/2020,17170,218889,512,1988,0,0,0,0,8682,593,593,0,729,5273,236059,6002,5,90
45,6/13/2020,17955,223951,523,1988,0,0,0,0,8682,599,599,0,785,5062,241906,5847,6,0
45,6/14/2020,18795,229541,521,1988,0,0,0,0,8682,600,600,0,840,5590,248336,6430,1,0
45,6/15/2020,19378,236179,536,1988,0,0,0,0,8682,602,602,0,583,6638,255557,7221,2,0
45,6/16/2020,19990,247689,571,2055,0,0,0,0,9734,607,607,0,612,11510,267679,12122,5,67
45,6/17/2020,20556,252198,607,2055,0,0,0,0,9734,617,617,0,566,4509,272754,5075,10,0
45,6/18/2020,21548,258975,626,2055,0,0,0,0,9734,621,621,0,992,6777,280523,7769,4,0
45,6/19/2020,22631,265669,660,2294,0,0,0,0,10790,639,639,0,1083,6694,288300,7777,18,239
45,6/20/2020,23786,272463,673,2294,0,0,0,0,10790,644,644,0,1155,6794,296249,7949,5,0
45,6/21/2020,24693,277974,692,2294,0,0,0,0,10790,653,653,0,907,5511,302667,6418,9,0
45,6/22/2020,25701,278179,731,2294,0,0,0,0,10790,659,659,0,1008,205,303880,1213,6,0
45,6/23/2020,26613,282638,824,2377,0,0,0,0,12317,673,673,0,912,4459,309251,5371,14,83
45,6/24/2020,27897,290311,832,2377,0,0,0,0,12317,683,683,0,1284,7673,318208,8957,10,0
45,6/25/2020,29022,304336,881,2377,0,0,0,0,12317,693,691,2,1125,14025,333358,15150,10,0
45,6/26/2020,30335,304336,906,2622,0,0,0,0,13456,694,692,2,1313,0,334671,1313,1,245
45,6/27/2020,31939,319225,908,2622,0,0,0,0,13456,711,707,4,1604,14889,351164,16493,17,0
45,6/28/2020,33320,326482,954,2622,0,0,0,0,13456,716,712,4,1381,7257,359802,8638,5,0
45,6/29/2020,34644,334661,1032,2622,0,0,0,0,13456,720,717,3,1324,8179,369305,9503,4,0
45,6/30/2020,36399,344173,1021,2854,0,0,0,0,15471,739,735,4,1755,9512,380572,11267,19,232
45,7/1/2020,37919,351953,1160,2854,0,0,0,0,15471,766,759,7,1520,7780,389872,9300,27,0
45,7/2/2020,39701,361700,1125,2854,0,0,0,0,15471,784,777,7,1782,9747,401401,11529,18,0
45,7/3/2020,41532,367500,1148,2882,0,0,0,0,16994,793,787,6,1831,5800,409032,7631,9,28
45,7/4/2020,43386,377307,1190,2882,0,0,0,0,16994,813,806,7,1854,9807,420693,11661,20,0
45,7/5/2020,44847,385962,1251,2882,0,0,0,0,16994,820,813,7,1461,8655,430809,10116,7,0
45,7/6/2020,46380,393477,1260,2882,0,0,0,0,16994,827,819,8,1533,7515,439857,9048,7,0
45,7/7/2020,47352,397939,1324,3090,0,0,0,0,19181,846,838,8,972,4462,445291,5434,19,208
45,7/8/2020,48909,404931,1404,3090,0,0,0,0,19181,884,876,8,1557,6992,453840,8549,38,0
45,7/9/2020,50691,413074,1433,3090,0,0,0,0,19181,905,898,7,1782,8143,463765,9925,21,0
45,7/10/2020,52419,422816,1438,3398,0,0,0,0,20956,929,922,7,1728,9742,475235,11470,24,308
45,7/11/2020,54699,433391,1396,3398,0,0,0,0,20956,951,940,11,2280,10575,488090,12855,22,0
45,7/12/2020,56648,435860,1472,3398,0,0,0,0,20957,961,950,11,1949,2469,492508,4418,10,0
45,7/13/2020,58168,448933,1488,3398,0,0,0,0,20957,972,961,11,1520,13073,507101,14593,11,0
45,7/14/2020,60389,457092,1550,3744,0,0,0,0,23849,993,984,9,2221,8159,517481,10380,21,346
45,7/15/2020,62245,463738,1560,3744,0,0,0,0,23849,998,984,14,1856,6646,525983,8502,5,0
45,7/16/2020,64083,475881,1578,3744,0,0,0,0,23849,1070,1053,17,1838,12143,539964,13981,72,0
45,7/17/2020,66060,487315,1593,4182,0,0,0,0,23849,1096,1078,18,1977,11434,553375,13411,26,438
46,3/7/2020,0,5,0,0,0,0,0,0,0,0,0,0,0,0,5,0,0,0
46,3/8/2020,0,5,0,0,0,0,0,0,0,0,0,0,0,0,5,0,0,0
46,3/9/2020,0,5,0,0,0,0,0,0,0,0,0,0,0,0,5,0,0,0
46,3/10/2020,0,11,0,0,0,0,0,0,0,0,0,0,0,6,11,6,0,0
46,3/11/2020,5,13,0,0,0,0,0,0,0,0,0,0,5,2,18,7,0,0
46,3/12/2020,8,27,0,0,0,0,0,0,0,0,0,0,3,14,35,17,0,0
46,3/13/2020,9,73,0,0,0,0,0,0,0,0,0,0,1,46,82,47,0,0
46,3/14/2020,9,182,0,0,0,0,0,0,0,0,0,0,0,109,191,109,0,0
46,3/15/2020,9,327,0,0,0,0,0,0,0,0,0,0,0,145,336,145,0,0
46,3/16/2020,10,494,0,0,0,0,0,0,0,0,0,0,1,167,504,168,0,0
46,3/17/2020,11,551,0,0,0,0,0,0,0,0,0,0,1,57,562,58,0,0
46,3/18/2020,11,551,0,0,0,0,0,0,0,1,0,0,0,0,562,0,1,0
46,3/19/2020,11,551,0,0,0,0,0,0,0,1,0,0,0,0,562,0,0,0
46,3/20/2020,14,663,0,0,0,0,0,0,0,1,0,0,3,112,677,115,0,0
46,3/21/2020,14,691,0,0,0,0,0,0,0,1,0,0,0,28,705,28,0,0
46,3/22/2020,21,740,0,0,0,0,0,0,0,1,0,0,7,49,761,56,0,0
46,3/23/2020,28,762,0,0,0,0,0,0,0,1,0,0,7,22,790,29,0,0
46,3/24/2020,30,790,0,0,0,0,0,0,0,1,0,0,2,28,820,30,0,0
46,3/25/2020,41,819,0,0,0,0,0,0,0,1,0,0,11,29,860,40,0,0
46,3/26/2020,46,1973,0,0,0,0,0,0,16,1,0,0,5,1154,2019,1159,0,0
46,3/27/2020,58,2387,0,0,0,0,0,0,21,1,0,0,12,414,2445,426,0,0
46,3/28/2020,68,2592,0,0,0,0,0,0,26,1,0,0,10,205,2660,215,0,0
46,3/29/2020,90,3127,0,0,0,0,0,0,29,1,0,0,22,535,3217,557,0,0
46,3/30/2020,101,3478,0,0,0,0,0,0,34,1,0,0,11,351,3579,362,0,0
46,3/31/2020,108,3609,0,12,0,0,0,0,44,1,0,0,7,131,3717,138,0,12
46,4/1/2020,129,3903,0,12,0,0,0,0,51,2,0,0,21,294,4032,315,1,0
46,4/2/2020,165,4217,0,17,0,0,0,0,57,2,0,0,36,314,4382,350,0,5
46,4/3/2020,187,4593,0,17,0,0,0,0,69,2,0,0,22,376,4780,398,0,0
46,4/4/2020,212,5012,0,19,0,0,0,0,76,2,0,0,25,419,5224,444,0,2
46,4/5/2020,240,5353,0,22,0,0,0,0,84,2,0,0,28,341,5593,369,0,3
46,4/6/2020,288,5732,0,23,0,0,0,0,91,4,0,0,48,379,6020,427,2,1
46,4/7/2020,320,5948,0,23,0,0,0,0,98,6,0,0,32,216,6268,248,2,0
46,4/8/2020,393,6355,0,26,0,0,0,0,146,6,0,0,73,407,6748,480,0,3
46,4/9/2020,447,6700,0,27,0,0,0,0,161,6,0,0,54,345,7147,399,0,1
46,4/10/2020,536,7111,0,29,0,0,0,0,177,6,0,0,89,411,7647,500,0,2
46,4/11/2020,626,7378,0,33,0,0,0,0,189,6,0,0,90,267,8004,357,0,4
46,4/12/2020,730,7823,0,43,0,0,0,0,197,6,0,0,104,445,8553,549,0,10
46,4/13/2020,868,8134,0,44,0,0,0,0,207,6,0,0,138,311,9002,449,0,1
46,4/14/2020,988,8308,0,45,0,0,0,0,261,6,0,0,120,174,9296,294,0,1
46,4/15/2020,1168,8691,0,51,0,0,0,0,329,6,0,0,180,383,9859,563,0,6
46,4/16/2020,1311,9239,0,55,0,0,0,0,373,7,0,0,143,548,10550,691,1,4
46,4/17/2020,1411,9651,0,63,0,0,0,0,457,7,0,0,100,412,11062,512,0,8
46,4/18/2020,1542,10118,0,68,0,0,0,0,552,7,0,0,131,467,11660,598,0,5
46,4/19/2020,1635,10427,0,74,0,0,0,0,646,7,0,0,93,309,12062,402,0,6
46,4/20/2020,1685,10641,0,87,0,0,0,0,709,7,0,0,50,214,12326,264,0,13
46,4/21/2020,1755,11060,65,100,0,0,0,0,824,8,0,0,70,419,12815,489,1,13
46,4/22/2020,1858,11588,62,111,0,0,0,0,937,8,0,0,103,528,13446,631,0,11
46,4/23/2020,1956,12109,58,119,0,0,0,0,1064,9,0,0,98,521,14065,619,1,8
46,4/24/2020,2040,12784,61,124,0,0,0,0,1190,10,0,0,84,675,14824,759,1,5
46,4/25/2020,2147,13449,61,128,0,0,0,0,1223,10,0,0,107,665,15596,772,0,4
46,4/26/2020,2212,14062,64,135,0,0,0,0,1257,11,0,0,65,613,16274,678,1,7
46,4/27/2020,2245,14130,61,150,0,0,0,0,1316,11,0,0,33,68,16375,101,0,15
46,4/28/2020,2313,14299,69,157,0,0,0,0,1392,11,0,0,68,169,16612,237,0,7
46,4/29/2020,2373,14460,69,165,0,0,0,0,1492,13,0,0,60,161,16833,221,2,8
46,4/30/2020,2449,14579,76,173,0,0,0,0,1573,17,0,0,76,119,17028,195,4,8
46,5/1/2020,2525,14838,69,179,0,0,0,0,1686,21,0,0,76,259,17363,335,4,6
46,5/2/2020,2588,15503,71,187,0,0,0,0,1759,21,0,0,63,665,18091,728,0,8
46,5/3/2020,2631,15786,71,197,0,0,0,0,1799,21,0,0,43,283,18417,326,0,10
46,5/4/2020,2668,16045,69,211,0,0,0,0,1830,21,0,0,37,259,18713,296,0,14
46,5/5/2020,2721,16301,75,220,0,0,0,0,1895,24,0,0,53,256,19022,309,3,9
46,5/6/2020,2779,16637,72,230,0,0,0,0,1977,29,0,0,58,336,19416,394,5,10
46,5/7/2020,2905,17209,70,236,0,0,0,0,2028,31,0,0,126,572,20114,698,2,6
46,5/8/2020,3144,18149,76,247,0,0,0,0,2069,31,0,0,239,940,21293,1179,0,11
46,5/9/2020,3393,19559,79,253,0,0,0,0,2125,34,0,0,249,1410,22952,1659,3,6
46,5/10/2020,3517,20377,77,261,0,0,0,0,2147,34,0,0,124,818,23894,942,0,8
46,5/11/2020,3614,20964,78,263,0,0,0,0,2187,34,0,0,97,587,24578,684,0,2
46,5/12/2020,3663,21534,74,271,0,0,0,0,2309,39,0,0,49,570,25197,619,5,8
46,5/13/2020,3732,22112,79,281,0,0,0,0,2367,39,0,0,69,578,25844,647,0,10
46,5/14/2020,3792,22681,85,290,0,0,0,0,2437,43,0,0,60,569,26473,629,4,9
46,5/15/2020,3887,23527,80,296,0,0,0,0,2574,44,0,0,95,846,27414,941,1,6
46,5/16/2020,3959,24217,75,304,0,0,0,0,2673,44,0,0,72,690,28176,762,0,8
46,5/17/2020,3987,24572,77,312,0,0,0,0,2724,44,0,0,28,355,28559,383,0,8
46,5/18/2020,4027,25018,77,316,0,0,0,0,2784,44,0,0,40,446,29045,486,0,4
46,5/19/2020,4085,25624,75,327,0,0,0,0,2914,46,0,0,58,606,29709,664,2,11
46,5/20/2020,4177,26212,81,333,0,0,0,0,3023,46,0,0,92,588,30389,680,0,6
46,5/21/2020,4250,27051,91,342,0,0,0,0,3145,48,0,0,73,839,31301,912,2,9
46,5/22/2020,4356,27988,83,351,0,0,0,0,3267,50,0,0,106,937,32344,1043,2,9
46,5/23/2020,4468,29060,90,358,0,0,0,0,3336,50,0,0,112,1072,33528,1184,0,7
46,5/24/2020,4563,30342,85,364,0,0,0,0,3371,50,0,0,95,1282,34905,1377,0,6
46,5/25/2020,4586,30697,99,370,0,0,0,0,3415,50,0,0,23,355,35283,378,0,6
46,5/26/2020,4653,32385,106,378,0,0,0,0,3528,50,0,0,67,1688,37038,1755,0,8
46,5/27/2020,4710,33296,101,391,0,0,0,0,3619,54,0,0,57,911,38006,968,4,13
46,5/28/2020,4793,34233,105,406,0,0,0,0,3698,54,0,0,83,937,39026,1020,0,15
46,5/29/2020,4866,35816,95,418,0,0,0,0,3744,59,0,0,73,1583,40682,1656,5,12
46,5/30/2020,4960,37978,93,427,0,0,0,0,3805,62,0,0,94,2162,42938,2256,3,9
46,5/31/2020,4993,39135,86,432,0,0,0,0,3837,62,0,0,33,1157,44128,1190,0,5
46,6/1/2020,5034,40627,87,435,0,0,0,0,3903,62,0,0,41,1492,45661,1533,0,3
46,6/2/2020,5067,41779,89,443,0,0,0,0,3990,62,0,0,33,1152,46846,1185,0,8
46,6/3/2020,5162,43500,87,456,0,0,0,0,4084,62,0,0,95,1721,48662,1816,0,13
46,6/4/2020,5247,47375,86,464,0,0,0,0,4163,64,0,0,85,3875,52622,3960,2,8
46,6/5/2020,5277,48086,83,467,0,0,0,0,4179,65,0,0,30,711,53363,741,1,3
46,6/6/2020,5367,50091,93,474,0,0,0,0,4273,65,0,0,90,2005,55458,2095,0,7
46,6/7/2020,5438,51622,87,478,0,0,0,0,4335,65,0,0,71,1531,57060,1602,0,4
46,6/8/2020,5471,52348,92,482,0,0,0,0,4403,65,0,0,33,726,57819,759,0,4
46,6/9/2020,5523,53636,90,487,0,0,0,0,4483,68,0,0,52,1288,59159,1340,3,5
46,6/10/2020,5604,55081,101,503,0,0,0,0,4573,69,0,0,81,1445,60685,1526,1,16
46,6/11/2020,5665,56079,87,514,0,0,0,0,4664,73,0,0,61,998,61744,1059,4,11
46,6/12/2020,5742,57263,87,525,0,0,0,0,4755,74,0,0,77,1184,63005,1261,1,11
46,6/13/2020,5833,58680,85,531,0,0,0,0,4828,75,0,0,91,1417,64513,1508,1,6
46,6/14/2020,5898,59421,87,539,0,0,0,0,4899,75,0,0,65,741,65319,806,0,8
46,6/15/2020,5928,60467,93,544,0,0,0,0,4961,75,0,0,30,1046,66395,1076,0,5
46,6/16/2020,5966,61236,92,562,0,0,0,0,5069,77,0,0,38,769,67202,807,2,18
46,6/17/2020,6050,62938,91,570,0,0,0,0,5143,78,0,0,84,1702,68988,1786,1,8
46,6/18/2020,6109,64244,93,585,0,0,0,0,5221,78,0,0,59,1306,70353,1365,0,15
46,6/19/2020,6158,65035,95,589,0,0,0,0,5276,81,0,0,49,791,71193,840,3,4
46,6/20/2020,6225,65690,91,598,0,0,0,0,5335,81,0,0,67,655,71915,722,0,9
46,6/21/2020,6297,66729,89,608,0,0,0,0,5389,81,0,0,72,1039,73026,1111,0,10
46,6/22/2020,6326,67003,88,616,0,0,0,0,5437,81,0,0,29,274,73329,303,0,8
46,6/23/2020,6353,67633,85,624,0,0,0,0,5497,83,0,0,27,630,73986,657,2,8
46,6/24/2020,6419,68658,81,629,0,0,0,0,5554,84,0,0,66,1025,75077,1091,1,5
46,6/25/2020,6479,69375,79,632,0,0,0,0,5592,87,0,0,60,717,75854,777,3,3
46,6/26/2020,6535,70480,79,639,0,0,0,0,5652,88,0,0,56,1105,77015,1161,1,7
46,6/27/2020,6626,71474,73,645,0,0,0,0,5717,91,0,0,91,994,78100,1085,3,6
46,6/28/2020,6681,72212,75,652,0,0,0,0,5752,91,0,0,55,738,78893,793,0,7
46,6/29/2020,6716,72741,70,657,0,0,0,0,5818,91,0,0,35,529,79457,564,0,5
46,6/30/2020,6764,73324,62,666,0,0,0,0,5872,91,0,0,48,583,80088,631,0,9
46,7/1/2020,6826,74117,65,674,0,0,0,0,5933,93,0,0,62,793,80943,855,2,8
46,7/2/2020,6893,75048,64,683,0,0,0,0,5982,97,0,0,67,931,81941,998,4,9
46,7/3/2020,6978,76015,58,687,0,0,0,0,6049,97,0,0,85,967,82993,1052,0,4
46,7/4/2020,7028,76802,54,689,0,0,0,0,6062,97,0,0,50,787,83830,837,0,2
46,7/5/2020,7063,76940,59,691,0,0,0,0,6063,97,0,0,35,138,84003,173,0,2
46,7/6/2020,7105,77198,59,692,0,0,0,0,6063,97,0,0,42,258,84303,300,0,1
46,7/7/2020,7163,78202,64,699,0,0,0,0,6190,98,0,0,58,1004,85365,1062,1,7
46,7/8/2020,7242,78984,54,709,0,0,0,0,6280,98,0,0,79,782,86226,861,0,10
46,7/9/2020,7336,79974,61,718,0,0,0,0,6331,101,0,0,94,990,87310,1084,3,9
46,7/10/2020,7401,81141,65,726,0,0,0,0,6408,107,0,0,65,1167,88542,1232,6,8
46,7/11/2020,7454,82152,65,738,0,0,0,0,6470,109,0,0,53,1011,89606,1064,2,12
46,7/12/2020,7499,83109,53,738,0,0,0,0,6522,109,0,0,45,957,90608,1002,0,0
46,7/13/2020,7524,83854,63,742,0,0,0,0,6543,109,0,0,25,745,91378,770,0,4
46,7/14/2020,7572,84592,62,744,0,0,0,0,6599,109,0,0,48,738,92164,786,0,2
46,7/15/2020,7652,85891,59,752,0,0,0,0,6663,111,0,0,80,1299,93543,1379,2,8
46,7/16/2020,7694,86342,61,757,0,0,0,0,6737,115,0,0,42,451,94036,493,4,5
46,7/17/2020,7789,88184,61,763,0,0,0,0,6808,116,0,0,95,1842,95973,1937,1,6
47,3/5/2020,1,0,0,0,0,0,0,0,0,0,0,0,0,0,1,0,0,0
47,3/6/2020,1,0,0,0,0,0,0,0,0,0,0,0,0,0,1,0,0,0
47,3/7/2020,1,0,0,0,0,0,0,0,0,0,0,0,0,0,1,0,0,0
47,3/8/2020,3,0,0,0,0,0,0,0,0,0,0,0,2,0,3,2,0,0
47,3/9/2020,3,0,0,0,0,0,0,0,0,0,0,0,0,0,3,0,0,0
47,3/10/2020,7,0,0,0,0,0,0,0,0,0,0,0,4,0,7,4,0,0
47,3/11/2020,7,50,0,0,0,0,0,0,0,0,0,0,0,50,57,50,0,0
47,3/12/2020,18,79,0,0,0,0,0,0,0,0,0,0,11,29,97,40,0,0
47,3/13/2020,26,116,0,0,0,0,0,0,0,0,0,0,8,37,142,45,0,0
47,3/14/2020,32,130,0,0,0,0,0,0,0,0,0,0,6,14,162,20,0,0
47,3/15/2020,39,157,0,0,0,0,0,0,0,0,0,0,7,27,196,34,0,0
47,3/16/2020,52,270,0,0,0,0,0,0,0,0,0,0,13,113,322,126,0,0
47,3/17/2020,73,330,0,0,0,0,0,0,0,0,0,0,21,60,403,81,0,0
47,3/18/2020,98,349,0,0,0,0,0,0,0,0,0,0,25,19,447,44,0,0
47,3/19/2020,154,349,0,0,0,0,0,0,0,0,0,0,56,0,503,56,0,0
47,3/20/2020,228,563,0,0,0,0,0,0,0,0,0,0,74,214,791,288,0,0
47,3/21/2020,371,3272,0,0,0,0,0,0,0,0,0,0,143,2709,3643,2852,0,0
47,3/22/2020,505,3272,0,0,0,0,0,0,0,0,0,0,134,0,3777,134,0,0
47,3/23/2020,615,3272,0,0,0,0,0,0,0,2,0,0,110,0,3887,110,2,0
47,3/24/2020,667,10517,0,0,0,0,0,0,0,2,0,0,52,7245,11184,7297,0,0
47,3/25/2020,784,11012,0,53,0,0,0,0,0,3,0,0,117,495,11796,612,1,53
47,3/26/2020,957,13952,0,76,0,0,0,0,0,3,0,0,173,2940,14909,3113,0,23
47,3/27/2020,1203,14888,0,103,0,0,0,0,0,6,0,0,246,936,16091,1182,3,27
47,3/28/2020,1373,16965,0,118,0,0,0,0,0,6,0,0,170,2077,18338,2247,0,15
47,3/29/2020,1537,19037,0,133,0,0,0,0,0,7,0,0,164,2072,20574,2236,1,15
47,3/30/2020,1834,21470,0,148,0,0,0,0,0,13,0,0,297,2433,23304,2730,6,15
47,3/31/2020,2239,25121,9,175,0,0,0,0,121,23,0,0,405,3651,27360,4056,10,27
47,4/1/2020,2683,29769,486,200,0,0,0,0,137,24,0,0,444,4648,32452,5092,1,25
47,4/2/2020,2845,31766,656,263,0,0,0,0,220,32,0,0,162,1997,34611,2159,8,63
47,4/3/2020,3067,34772,625,293,0,0,0,0,248,37,0,0,222,3006,37839,3228,5,30
47,4/4/2020,3321,38070,601,311,0,0,0,0,416,43,0,0,254,3298,41391,3552,6,18
47,4/5/2020,3633,41667,637,328,0,0,0,0,295,44,0,0,312,3597,45300,3909,1,17
47,4/6/2020,3802,43548,834,352,0,0,0,0,356,65,0,0,169,1881,47350,2050,21,24
47,4/7/2020,4138,48736,802,408,0,0,0,0,466,72,0,0,336,5188,52874,5524,7,56
47,4/8/2020,4362,52256,708,449,0,0,0,0,592,79,0,0,224,3520,56618,3744,7,41
47,4/9/2020,4634,55215,639,505,0,0,0,0,921,94,0,0,272,2959,59849,3231,15,56
47,4/10/2020,4862,57937,561,536,0,0,0,0,1145,98,0,0,228,2722,62799,2950,4,31
47,4/11/2020,5114,61714,411,556,0,0,0,0,1386,101,0,0,252,3777,66828,4029,3,20
47,4/12/2020,5308,65369,324,567,0,0,0,0,1504,101,0,0,194,3655,70677,3849,0,11
47,4/13/2020,5610,70585,458,579,0,0,0,0,1671,109,0,0,302,5216,76195,5518,8,12
47,4/14/2020,5823,73008,443,633,0,0,0,0,1969,124,0,0,213,2423,78831,2636,15,54
47,4/15/2020,6079,74817,412,663,0,0,0,0,2196,135,0,0,256,1809,80896,2065,11,30
47,4/16/2020,6262,78787,444,691,0,0,0,0,2786,141,0,0,183,3970,85049,4153,6,28
47,4/17/2020,6589,80684,465,711,0,0,0,0,3017,142,0,0,327,1897,87273,2224,1,20
47,4/18/2020,6762,83824,593,719,0,0,0,0,3234,145,0,0,173,3140,90586,3313,3,8
47,4/19/2020,7070,90028,393,724,0,0,0,0,3344,148,0,0,308,6204,97098,6512,3,5
47,4/20/2020,7238,93451,505,730,0,0,0,0,3575,152,0,0,168,3423,100689,3591,4,6
47,4/21/2020,7394,100788,523,760,0,0,0,0,3828,157,0,0,156,7337,108182,7493,5,30
47,4/22/2020,7842,107138,441,775,0,0,0,0,4012,166,0,0,448,6350,114980,6798,9,15
47,4/23/2020,8266,114834,488,793,0,0,0,0,4193,170,0,0,424,7696,123100,8120,4,18
47,4/24/2020,8726,122602,593,808,0,0,0,0,4370,168,0,0,460,7768,131328,8228,-2,15
47,4/25/2020,9189,132217,510,821,0,0,0,0,4467,178,0,0,463,9615,141406,10078,10,13
47,4/26/2020,9667,137807,568,828,0,0,0,0,4527,181,0,0,478,5590,147474,6068,3,7
47,4/27/2020,9918,144484,618,837,0,0,0,0,4720,184,0,0,251,6677,154402,6928,3,9
47,4/28/2020,10052,151876,611,894,0,0,0,0,4921,188,0,0,134,7392,161928,7526,4,57
47,4/29/2020,10366,158183,614,1013,0,0,0,0,5140,195,0,0,314,6307,168549,6621,7,119
47,4/30/2020,10735,166891,605,1045,0,0,0,0,5338,199,0,0,369,8708,177626,9077,4,32
47,5/1/2020,11891,174241,529,1113,0,0,0,0,5546,204,0,0,1156,7350,186132,8506,5,68
47,5/2/2020,12661,183615,474,1125,0,0,0,0,5718,209,0,0,770,9374,196276,10144,5,12
47,5/3/2020,13177,191430,510,1135,0,0,0,0,5814,210,0,0,516,7815,204607,8331,1,10
47,5/4/2020,13571,197872,499,1143,0,0,0,0,6081,219,0,0,394,6442,211443,6836,9,8
47,5/5/2020,13690,205172,520,1156,0,0,0,0,6356,226,0,0,119,7300,218862,7419,7,13
47,5/6/2020,13938,213163,557,1221,0,0,0,0,6564,239,0,0,248,7991,227101,8239,13,65
47,5/7/2020,14096,222232,558,1266,0,0,0,0,6783,237,0,0,158,9069,236328,9227,-2,45
47,5/8/2020,14441,229137,550,1299,0,0,0,0,7011,241,0,0,345,6905,243578,7250,4,33
47,5/9/2020,14768,237980,509,1319,0,0,0,0,7369,242,0,0,327,8843,252748,9170,1,20
47,5/10/2020,14985,246884,484,1325,0,0,0,0,7528,243,0,0,217,8904,261869,9121,1,6
47,5/11/2020,15544,257733,581,1344,0,0,0,0,8038,251,0,0,559,10849,273277,11408,8,19
47,5/12/2020,16111,267713,591,1363,0,0,0,0,8336,265,265,0,567,9980,283824,10547,14,19
47,5/13/2020,16370,276547,635,1388,0,0,0,0,8624,273,273,0,259,8834,292917,9093,8,25
47,5/14/2020,16699,285618,599,1435,0,0,0,0,8881,287,287,0,329,9071,302317,9400,14,47
47,5/15/2020,16970,292786,535,1454,0,0,0,0,9280,290,290,0,271,7168,309756,7439,3,19
47,5/16/2020,17288,302913,515,1474,0,0,0,0,9529,295,295,0,318,10127,320201,10445,5,20
47,5/17/2020,17388,307892,513,1482,0,0,0,0,9652,298,298,0,100,4979,325280,5079,3,8
47,5/18/2020,18011,319417,638,1489,0,0,0,0,9886,301,301,0,623,11525,337428,12148,3,7
47,5/19/2020,18378,327745,615,1498,0,0,0,0,10969,305,305,0,367,8328,346123,8695,4,9
47,5/20/2020,18532,335481,652,1515,0,0,0,0,11783,309,309,0,154,7736,354013,7890,4,17
47,5/21/2020,18961,341622,601,1539,0,0,0,0,12191,313,313,0,429,6141,360583,6570,4,24
47,5/22/2020,19394,348776,570,1560,0,0,0,0,12566,315,315,0,433,7154,368170,7587,2,21
47,5/23/2020,19789,353969,478,1573,0,0,0,0,12745,329,329,0,395,5193,373758,5588,14,13
47,5/24/2020,20145,363431,526,1583,0,0,0,0,12837,336,336,0,356,9462,383576,9818,7,10
47,5/25/2020,20607,375612,517,1594,0,0,0,0,13073,338,338,0,462,12181,396219,12643,2,11
47,5/26/2020,20965,382539,582,1609,0,0,0,0,13344,343,343,0,358,6927,403504,7285,5,15
47,5/27/2020,21306,388324,501,1647,0,0,0,0,13916,353,353,0,341,5785,409630,6126,10,38
47,5/28/2020,21679,394310,545,1689,0,0,0,0,14632,356,356,0,373,5986,415989,6359,3,42
47,5/29/2020,22085,399882,507,1710,0,0,0,0,14965,360,360,0,406,5572,421967,5978,4,21
47,5/30/2020,22566,404480,516,1732,0,0,0,0,15193,364,364,0,481,4598,427046,5079,4,22
47,5/31/2020,23006,412971,463,1750,0,0,0,0,15300,364,364,0,440,8491,435977,8931,0,18
47,6/1/2020,23554,424939,504,1767,0,0,0,0,15564,367,367,0,548,11968,448493,12516,3,17
47,6/2/2020,24375,437761,565,1792,0,0,0,0,15916,381,381,0,821,12822,462136,13643,14,25
47,6/3/2020,24822,445957,548,1829,0,0,0,0,16319,388,388,0,447,8196,470779,8643,7,37
47,6/4/2020,25120,451018,547,1855,0,0,0,0,16643,401,401,0,298,5061,476138,5359,13,26
47,6/5/2020,25520,456652,505,1893,0,0,0,0,16925,408,408,0,400,5634,482172,6034,7,38
47,6/6/2020,26071,465350,535,1923,0,0,0,0,17124,417,417,0,551,8698,491421,9249,9,30
47,6/7/2020,26381,472387,561,1932,0,0,0,0,17222,418,418,0,310,7037,498768,7347,1,9
47,6/8/2020,26944,485819,617,1948,0,0,0,0,17563,421,421,0,563,13432,512763,13995,3,16
47,6/9/2020,27575,493622,587,1974,0,0,0,0,18013,435,435,0,631,7803,521197,8434,14,26
47,6/10/2020,28061,500766,624,1990,0,0,0,0,18516,436,436,0,486,7144,528827,7630,1,16
47,6/11/2020,28538,506756,606,2011,0,0,0,0,18992,441,441,0,477,5990,535294,6467,5,21
47,6/12/2020,29126,561047,608,2049,0,0,0,0,19425,468,447,21,588,54291,590173,54879,27,38
47,6/13/2020,29541,571821,583,2073,0,0,0,0,19731,472,451,21,415,10774,601362,11189,4,24
47,6/14/2020,30432,584788,588,2087,0,0,0,0,19896,475,454,21,891,12967,615220,13858,3,14
47,6/15/2020,31160,598818,642,2106,0,0,0,0,20062,483,462,21,728,14030,629978,14758,8,19
47,6/16/2020,31830,607160,621,2146,0,0,0,0,20710,493,472,21,670,8342,638990,9012,10,40
47,6/17/2020,32143,612430,632,2180,0,0,0,0,21282,497,476,21,313,5270,644573,5583,4,34
47,6/18/2020,32829,619565,617,2209,0,0,0,0,21949,509,488,21,686,7135,652394,7821,12,29
47,6/19/2020,34017,627672,635,2238,0,0,0,0,22531,515,494,21,1188,8107,661689,9295,6,29
47,6/20/2020,34446,640894,588,2266,0,0,0,0,22838,524,503,21,429,13222,675340,13651,9,28
47,6/21/2020,35102,650527,605,2291,0,0,0,0,23067,526,505,21,656,9633,685629,10289,2,25
47,6/22/2020,35553,664552,664,2301,0,0,0,0,23567,531,510,21,451,14025,700105,14476,5,10
47,6/23/2020,36303,669116,721,2336,0,0,0,0,24068,542,521,21,750,4564,705419,5314,11,35
47,6/24/2020,37235,681069,696,2386,0,0,0,0,24693,556,535,21,932,11953,718304,12885,14,50
47,6/25/2020,38034,689515,741,2431,0,0,0,0,25280,567,540,27,799,8446,727549,9245,11,45
47,6/26/2020,39444,702588,741,2498,0,0,0,0,25753,577,552,25,1410,13073,742032,14483,10,67
47,6/27/2020,40172,708381,705,2564,0,0,0,0,26159,584,560,24,728,5793,748553,6521,7,66
47,6/28/2020,40172,708381,800,2564,0,0,0,0,26159,584,560,24,0,0,748553,0,0,0
47,6/29/2020,42297,734909,839,2599,0,0,0,0,26962,592,568,24,2125,26528,777206,28653,8,35
47,6/30/2020,43509,749618,886,2665,0,0,0,0,27599,604,578,26,1212,14709,793127,15921,12,66
47,7/1/2020,45315,772571,955,2715,0,0,0,0,28283,609,583,26,1806,22953,817886,24759,5,50
47,7/2/2020,46890,791564,949,2775,0,0,0,0,28938,620,594,26,1575,18993,838454,20568,11,60
47,7/3/2020,48712,813777,949,2825,0,0,0,0,29591,633,608,25,1822,22213,862489,24035,13,50
47,7/4/2020,50140,828464,949,2860,0,0,0,0,30043,637,612,25,1428,14687,878604,16115,4,35
47,7/5/2020,51431,844735,949,2871,0,0,0,0,30254,646,621,25,1291,16271,896166,17562,9,11
47,7/6/2020,52155,852463,940,2897,0,0,0,0,31020,653,628,25,724,7728,904618,8452,7,26
47,7/7/2020,53514,867685,1112,2950,0,0,0,0,31827,665,640,25,1359,15222,921199,16581,12,53
47,7/8/2020,55986,894973,1160,3023,0,0,0,0,32736,685,660,25,2472,27288,950959,29760,20,73
47,7/9/2020,57591,915123,1135,3088,0,0,0,0,33609,710,684,26,1605,20150,972714,21755,25,65
47,7/10/2020,59546,935029,1184,3146,0,0,0,0,34740,723,697,26,1955,19906,994575,21861,13,58
47,7/11/2020,61006,946108,1184,3193,0,0,0,0,35435,738,711,27,1460,11079,1007114,12539,15,47
47,7/12/2020,61960,956055,1184,3250,0,0,0,0,35855,741,714,27,954,9947,1018015,10901,3,57
47,7/13/2020,65274,988687,1120,3284,0,0,0,0,36996,749,722,27,3314,32632,1053961,35946,8,34
47,7/14/2020,66788,1005100,1222,3378,0,0,0,0,38272,767,740,27,1514,16413,1071888,17927,18,94
47,7/15/2020,69061,1028612,1282,3434,0,0,0,0,39857,783,755,28,2273,23512,1097673,25785,16,56
47,7/16/2020,71540,1052157,1416,3497,0,0,0,0,41250,796,767,29,2479,23545,1123697,26024,13,63
47,7/17/2020,73819,1076853,1436,3562,0,0,0,0,42734,815,785,30,2279,24696,1150672,26975,19,65
48,3/4/2020,1,0,0,0,0,0,0,0,0,0,0,0,0,0,1,0,0,0
48,3/5/2020,1,0,0,0,0,0,0,0,0,0,0,0,0,0,1,0,0,0
48,3/6/2020,5,0,0,0,0,0,0,0,0,0,0,0,4,0,5,4,0,0
48,3/7/2020,8,0,0,0,0,0,0,0,0,0,0,0,3,0,8,3,0,0
48,3/8/2020,8,0,0,0,0,0,0,0,0,0,0,0,0,0,8,0,0,0
48,3/9/2020,12,0,0,0,0,0,0,0,0,0,0,0,4,0,12,4,0,0
48,3/10/2020,13,0,0,0,0,0,0,0,0,0,0,0,1,0,13,1,0,0
48,3/11/2020,21,0,0,0,0,0,0,0,0,0,0,0,8,0,21,8,0,0
48,3/12/2020,23,0,0,0,0,0,0,0,0,0,0,0,2,0,23,2,0,0
48,3/13/2020,39,0,0,0,0,0,0,0,0,0,0,0,16,0,39,16,0,0
48,3/14/2020,51,0,0,0,0,0,0,0,0,0,0,0,12,0,51,12,0,0
48,3/15/2020,56,0,0,0,0,0,0,0,0,0,0,0,5,0,56,5,0,0
48,3/16/2020,57,0,0,0,0,0,0,0,0,0,0,0,1,0,57,1,0,0
48,3/17/2020,64,1204,0,0,0,0,0,0,0,1,0,0,7,1204,1268,1211,1,0
48,3/18/2020,83,1824,0,0,0,0,0,0,0,2,0,0,19,620,1907,639,1,0
48,3/19/2020,143,2212,0,0,0,0,0,0,0,3,0,0,60,388,2355,448,1,0
48,3/20/2020,194,5083,0,0,0,0,0,0,0,5,0,0,51,2871,5277,2922,2,0
48,3/21/2020,304,6218,0,0,0,0,0,0,0,5,0,0,110,1135,6522,1245,0,0
48,3/22/2020,334,8422,0,0,0,0,0,0,0,5,0,0,30,2204,8756,2234,0,0
48,3/23/2020,352,9703,0,0,0,0,0,0,0,8,0,0,18,1281,10055,1299,3,0
48,3/24/2020,410,10757,0,0,0,0,0,0,0,9,0,0,58,1054,11167,1112,1,0
48,3/25/2020,974,12520,0,0,0,0,0,0,0,12,0,0,564,1763,13494,2327,3,0
48,3/26/2020,1396,20028,0,0,0,0,0,0,0,18,0,0,422,7508,21424,7930,6,0
48,3/27/2020,1731,21935,0,0,0,0,0,0,0,23,0,0,335,1907,23666,2242,5,0
48,3/28/2020,2052,23208,0,0,0,0,0,0,0,27,0,0,321,1273,25260,1594,4,0
48,3/29/2020,2552,23208,0,0,0,0,0,0,0,34,0,0,500,0,25760,500,7,0
48,3/30/2020,2877,33003,0,0,0,0,0,0,38,34,0,0,325,9795,35880,10120,0,0
48,3/31/2020,3266,39726,196,0,0,0,0,0,38,41,0,0,389,6723,42992,7112,7,0
48,4/1/2020,3997,43860,196,0,0,0,0,0,38,58,0,0,731,4134,47857,4865,17,0
48,4/2/2020,4669,46010,196,0,0,0,0,0,38,70,0,0,672,2150,50679,2822,12,0
48,4/3/2020,5330,50434,196,0,0,0,0,0,38,90,0,0,661,4424,55764,5085,20,0
48,4/4/2020,6110,57641,196,0,0,0,0,0,38,105,0,0,780,7207,63751,7987,15,0
48,4/5/2020,6812,64126,827,0,0,0,0,0,38,127,0,0,702,6485,70938,7187,22,0
48,4/6/2020,7276,78081,1153,0,0,0,0,0,38,140,0,0,464,13955,85357,14419,13,0
48,4/7/2020,8262,80387,1252,0,0,0,0,0,38,154,0,0,986,2306,88649,3292,14,0
48,4/8/2020,9353,86905,1491,0,0,0,0,0,38,177,0,0,1091,6518,96258,7609,23,0
48,4/9/2020,10230,95904,1439,0,0,0,0,0,1101,199,0,0,877,8999,106134,9876,22,0
48,4/10/2020,11671,104047,1532,0,0,0,0,0,1366,226,0,0,1441,8143,115718,9584,27,0
48,4/11/2020,12561,107972,1514,0,0,0,0,0,1617,254,0,0,890,3925,120533,4815,28,0
48,4/12/2020,13484,111049,1338,0,0,0,0,0,2014,271,0,0,923,3077,124533,4000,17,0
48,4/13/2020,13906,119320,1176,0,0,0,0,0,2269,287,0,0,422,8271,133226,8693,16,0
48,4/14/2020,14624,131843,1409,0,0,0,0,0,2580,318,0,0,718,12523,146467,13241,31,0
48,4/15/2020,15492,136318,1538,0,0,0,0,0,3150,364,0,0,868,4475,151810,5343,46,0
48,4/16/2020,16455,142092,1459,0,0,0,0,0,3677,393,0,0,963,5774,158547,6737,29,0
48,4/17/2020,17371,152165,1522,0,0,0,0,0,4190,428,0,0,916,10073,169536,10989,35,0
48,4/18/2020,18260,157979,1321,0,0,0,0,0,4806,453,0,0,889,5814,176239,6703,25,0
48,4/19/2020,18923,163787,1471,0,0,0,0,0,5334,477,0,0,663,5808,182710,6471,24,0
48,4/20/2020,19458,170936,1411,0,0,0,0,0,5706,495,0,0,535,7149,190394,7684,18,0
48,4/21/2020,20196,185203,1419,0,0,0,0,0,6486,517,0,0,738,14267,205399,15005,22,0
48,4/22/2020,21069,195714,1678,0,0,0,0,0,7341,543,0,0,873,10511,216783,11384,26,0
48,4/23/2020,21944,203134,1649,0,0,0,0,0,8025,561,0,0,875,7420,225078,8295,18,0
48,4/24/2020,22806,219741,1674,0,0,0,0,0,9156,593,0,0,862,16607,242547,17469,32,0
48,4/25/2020,23773,239043,1597,0,0,0,0,0,9986,623,0,0,967,19302,262816,20269,30,0
48,4/26/2020,24631,251390,1542,0,0,0,0,0,10763,648,0,0,858,12347,276021,13205,25,0
48,4/27/2020,25297,265220,1563,0,0,0,0,0,11170,663,0,0,666,13830,290517,14496,15,0
48,4/28/2020,26171,274213,1682,0,0,0,0,0,11786,690,0,0,874,8993,300384,9867,27,0
48,4/29/2020,27054,287736,1702,0,0,0,0,0,12507,732,0,0,883,13523,314790,14406,42,0
48,4/30/2020,28087,302213,1686,0,0,0,0,0,13353,782,0,0,1033,14477,330300,15510,50,0
48,5/1/2020,29229,322546,1778,0,0,0,0,0,14122,816,0,0,1142,20333,351775,21475,34,0
48,5/2/2020,30522,350126,1725,0,0,0,0,0,14891,847,0,0,1293,27580,380648,28873,31,0
48,5/3/2020,31548,359012,1540,0,0,0,0,0,15544,867,0,0,1026,8886,390560,9912,20,0
48,5/4/2020,32332,375066,1533,0,0,0,0,0,16090,884,0,0,784,16054,407398,16838,17,0
48,5/5/2020,33369,393841,1888,0,0,0,0,0,16791,906,0,0,1037,18775,427210,19812,22,0
48,5/6/2020,34422,404516,1812,0,0,0,0,0,17622,948,0,0,1053,10675,438938,11728,42,0
48,5/7/2020,35390,419772,1750,0,0,0,0,0,18440,973,0,0,968,15256,455162,16224,25,0
48,5/8/2020,36609,440509,1734,0,0,0,0,0,19197,1004,0,0,1219,20737,477118,21956,31,0
48,5/9/2020,37860,451434,1735,0,0,0,0,0,20141,1049,0,0,1251,10925,489294,12176,45,0
48,5/10/2020,38869,462907,1626,0,0,0,0,0,21022,1088,0,0,1009,11473,501776,12482,39,0
48,5/11/2020,39869,485828,1525,0,0,0,0,0,21713,1100,0,0,1000,22921,525697,23921,12,0
48,5/12/2020,41048,497124,1725,0,0,0,0,0,22674,1133,0,0,1179,11296,538172,12475,33,0
48,5/13/2020,42403,514373,1676,0,0,0,0,0,23519,1158,0,0,1355,17249,556776,18604,25,0
48,5/14/2020,43851,543462,1648,0,0,0,0,0,24487,1216,0,0,1448,29089,587313,30537,58,0
48,5/15/2020,45198,564432,1716,0,0,0,0,0,25454,1272,0,0,1347,20970,609630,22317,56,0
48,5/16/2020,46999,591740,1791,0,0,0,0,0,26601,1305,0,0,1801,27308,638739,29109,33,0
48,5/17/2020,47784,602571,1512,0,0,0,0,0,27570,1336,0,0,785,10831,650355,11616,31,0
48,5/18/2020,48693,631152,1551,0,0,0,0,0,28371,1347,0,0,909,28581,679845,29490,11,0
48,5/19/2020,49912,650234,1732,0,0,0,0,0,29359,1369,0,0,1219,19082,700146,20301,22,0
48,5/20/2020,51323,669605,1791,0,0,0,0,0,30341,1419,0,0,1411,19371,720928,20782,50,0
48,5/21/2020,52268,687913,1680,0,0,0,0,0,30341,1440,0,0,945,18308,740181,19253,21,0
48,5/22/2020,53449,687913,1578,0,0,0,0,0,31223,1480,0,0,1181,0,741362,1181,40,0
48,5/23/2020,54509,708197,1688,0,0,0,0,0,32277,1506,0,0,1060,20284,762706,21344,26,0
48,5/24/2020,55348,708197,1572,0,0,0,0,0,33385,1506,0,0,839,0,763545,839,0,0
48,5/25/2020,55971,749683,1511,0,0,0,0,0,35292,1527,0,0,623,41486,805654,42109,21,0
48,5/26/2020,56560,764673,1534,0,0,0,0,0,36375,1536,0,0,589,14990,821233,15579,9,0
48,5/27/2020,57921,797753,1645,0,0,0,0,0,37626,1562,0,0,1361,33080,855674,34441,26,0
48,5/28/2020,59776,813442,1692,0,0,0,0,0,38905,1601,0,0,1855,15689,873218,17544,39,0
48,5/29/2020,61006,832269,1701,0,0,0,0,0,40068,1626,0,0,1230,18827,893275,20057,25,0
48,5/30/2020,62338,866179,1752,0,0,0,0,0,40068,1626,0,0,1332,33910,928517,35242,0,0
48,5/31/2020,64287,887578,1684,0,0,0,0,0,42423,1672,0,0,1949,21399,951865,23348,46,0
48,6/1/2020,64880,905151,1756,0,0,0,0,0,43338,1678,0,0,593,17573,970031,18166,6,0
48,6/2/2020,66568,919656,1773,0,0,0,0,0,44517,1698,0,0,1688,14505,986224,16193,20,0
48,6/3/2020,68271,938497,1487,0,0,0,0,0,45858,1734,0,0,1703,18841,1006768,20544,36,0
48,6/4/2020,69920,968635,1796,0,0,0,0,0,46799,1767,0,0,1649,30138,1038555,31787,33,0
48,6/5/2020,71613,989963,1855,0,0,0,0,0,47865,1788,0,0,1693,21328,1061576,23021,21,0
48,6/6/2020,73553,1019724,1822,0,0,0,0,0,48895,1819,0,0,1940,29761,1093277,31701,31,0
48,6/7/2020,74978,1025468,1878,0,0,0,0,0,49758,1830,0,0,1425,5744,1100446,7169,11,0
48,6/8/2020,75616,1044700,1935,0,0,0,0,0,49758,1830,0,0,638,19232,1120316,19870,0,0
48,6/9/2020,77253,1070102,2056,0,0,0,0,0,51140,1853,0,0,1637,25402,1147355,27039,23,0
48,6/10/2020,79757,1081330,2153,0,0,0,0,0,52449,1885,0,0,2504,11228,1161087,13732,32,0
48,6/11/2020,81583,1124737,2008,0,0,0,0,0,54096,1920,0,0,1826,43407,1206320,45233,35,0
48,6/12/2020,83680,1143277,2166,0,0,0,0,0,55258,1939,0,0,2097,18540,1226957,20637,19,0
48,6/13/2020,86011,1174308,2242,0,0,0,0,0,56535,1957,0,0,2331,31031,1260319,33362,18,0
48,6/14/2020,87854,1208129,2287,0,0,0,0,0,58341,1976,0,0,1843,33821,1295983,35664,19,0
48,6/15/2020,89108,1225653,2326,0,0,0,0,0,59089,1983,0,0,1254,17524,1314761,18778,7,0
48,6/16/2020,93206,1255236,2518,0,0,0,0,0,60681,2029,0,0,4098,29583,1348442,33681,46,0
48,6/17/2020,96335,1273303,2793,0,0,0,0,0,62368,2062,0,0,3129,18067,1369638,21196,33,0
48,6/18/2020,99851,1307890,2947,0,0,0,0,0,63812,2105,0,0,3516,34587,1407741,38103,43,0
48,6/19/2020,103305,1320609,3148,0,0,0,0,0,65329,2140,0,0,3454,12719,1423914,16173,35,0
48,6/20/2020,107735,1355663,3247,0,0,0,0,0,67096,2165,0,0,4430,35054,1463398,39484,25,0
48,6/21/2020,111601,1414579,3409,0,0,0,0,0,68499,2182,0,0,3866,58916,1526180,62782,17,0
48,6/22/2020,114881,1434128,3711,0,0,0,0,0,69190,2192,0,0,3280,19549,1549009,22829,10,0
48,6/23/2020,120370,1476920,4092,0,0,0,0,0,70714,2220,0,0,5489,42792,1597290,48281,28,0
48,6/24/2020,125921,1504337,4389,0,0,0,0,0,72898,2249,0,0,5551,27417,1630258,32968,29,0
48,6/25/2020,131917,1527423,4739,0,0,0,0,0,74496,2296,0,0,5996,23086,1659340,29082,47,0
48,6/26/2020,137624,1559710,5102,0,0,0,0,0,76282,2324,0,0,5707,32287,1697334,37994,28,0
48,6/27/2020,143371,1579455,5523,0,0,0,0,0,78248,2366,0,0,5747,19745,1722826,25492,42,0
48,6/28/2020,148728,1626491,5497,0,0,0,0,0,79974,2393,0,0,5357,47036,1775219,52393,27,0
48,6/29/2020,153011,1666178,5913,0,0,0,0,0,81335,2403,0,0,4283,39687,1819189,43970,10,0
48,6/30/2020,159986,1709296,6533,0,0,0,0,0,84818,2424,0,0,6975,43118,1869282,50093,21,0
48,7/1/2020,168062,1753886,6904,0,0,0,0,0,87556,2481,0,0,8076,44590,1921948,52666,57,0
48,7/2/2020,175977,1799826,7382,0,0,0,0,0,90720,2525,0,0,7915,45940,1975803,53855,44,0
48,7/3/2020,183532,1830374,7652,0,0,0,0,0,93572,2575,0,0,7555,30548,2013906,38103,50,0
48,7/4/2020,191790,1880019,7890,0,0,0,0,0,97430,2608,0,0,8258,49645,2071809,57903,33,0
48,7/5/2020,195239,1938218,8181,0,0,0,0,0,100843,2637,0,0,3449,58199,2133457,61648,29,0
48,7/6/2020,200557,1963172,8698,0,0,0,0,0,103782,2655,0,0,5318,24954,2163729,30272,18,0
48,7/7/2020,210585,2010702,9286,0,0,0,0,0,108485,2715,0,0,10028,47530,2221287,57558,60,0
48,7/8/2020,220564,2038144,9610,0,0,0,0,0,113284,2813,0,0,9979,27442,2258708,37421,98,0
48,7/9/2020,230346,2082866,9689,0,0,0,0,0,118326,2918,0,0,9782,44722,2313212,54504,105,0
48,7/10/2020,240111,2149678,10002,0,0,0,0,0,122996,3013,0,0,9765,66812,2389789,76577,95,0
48,7/11/2020,250462,2179162,10083,0,0,0,0,0,127880,3112,0,0,10351,29484,2429624,39835,99,0
48,7/12/2020,258658,2234096,10410,0,0,0,0,0,132638,3192,0,0,8196,54934,2492754,63130,80,0
48,7/13/2020,264313,2275812,10405,0,0,0,0,0,136419,3235,0,0,5655,41716,2540125,47371,43,0
48,7/14/2020,275058,2323622,10569,0,0,0,0,0,142398,3322,0,0,10745,47810,2598680,58555,87,0
48,7/15/2020,282365,2359834,10471,0,0,0,0,0,149276,3432,0,0,7307,36212,2642199,43519,110,0
48,7/16/2020,292656,2407199,10457,0,0,0,0,0,155937,3561,0,0,10291,47365,2699855,57656,129,0
48,7/17/2020,307572,2459749,10632,0,0,0,0,0,162191,3735,0,0,14916,52550,2767321,67466,174,0
50,3/6/2020,0,0,0,0,0,0,0,0,0,0,0,0,0,0,0,0,0,0
50,3/7/2020,1,25,0,0,0,0,0,0,0,0,0,0,1,25,26,26,0,0
50,3/8/2020,1,30,0,0,0,0,0,0,0,0,0,0,0,5,31,5,0,0
50,3/9/2020,1,36,0,0,0,0,0,0,0,0,0,0,0,6,37,6,0,0
50,3/10/2020,1,60,0,0,0,0,0,0,0,0,0,0,0,24,61,24,0,0
50,3/11/2020,2,91,0,0,0,0,0,0,0,0,0,0,1,31,93,32,0,0
50,3/12/2020,2,136,0,0,0,0,0,0,0,0,0,0,0,45,138,45,0,0
50,3/13/2020,5,223,0,0,0,0,0,0,0,0,0,0,3,87,228,90,0,0
50,3/14/2020,8,332,0,0,0,0,0,0,0,0,0,0,3,109,340,112,0,0
50,3/15/2020,12,405,0,0,0,0,0,0,0,0,0,0,4,73,417,77,0,0
50,3/16/2020,17,487,0,0,0,0,0,0,0,0,0,0,5,82,504,87,0,0
50,3/17/2020,19,581,0,0,0,0,0,0,0,0,0,0,2,94,600,96,0,0
50,3/18/2020,21,637,0,0,0,0,0,0,0,0,0,0,2,56,658,58,0,0
50,3/19/2020,28,764,0,0,0,0,0,0,0,0,0,0,7,127,792,134,0,0
50,3/20/2020,44,957,0,0,0,0,0,0,0,2,0,0,16,193,1001,209,2,0
50,3/21/2020,52,1080,0,0,0,0,0,0,0,2,0,0,8,123,1132,131,0,0
50,3/22/2020,76,1204,0,0,0,0,0,0,0,2,0,0,24,124,1280,148,0,0
50,3/23/2020,97,1424,0,0,0,0,0,0,0,5,0,0,21,220,1521,241,3,0
50,3/24/2020,125,1569,0,0,0,0,0,0,0,7,0,0,28,145,1694,173,2,0
50,3/25/2020,160,1810,0,0,0,0,0,0,0,8,0,0,35,241,1970,276,1,0
50,3/26/2020,185,2744,0,0,0,0,0,0,0,9,0,0,25,934,2929,959,1,0
50,3/27/2020,213,2868,0,18,0,0,0,0,0,10,0,0,28,124,3081,152,1,18
50,3/28/2020,234,3192,0,18,0,0,0,0,0,12,0,0,21,324,3426,345,2,0
50,3/29/2020,256,3483,0,18,0,0,0,0,0,12,0,0,22,291,3739,313,0,0
50,3/30/2020,293,3718,0,18,0,0,0,0,0,12,0,0,37,235,4011,272,0,0
50,3/31/2020,320,3949,21,36,0,0,0,0,15,13,0,0,27,231,4269,258,1,18
50,4/1/2020,359,4162,30,45,0,0,0,0,15,16,0,0,39,213,4521,252,3,9
50,4/2/2020,390,4384,29,45,0,0,0,0,15,17,0,0,31,222,4774,253,1,0
50,4/3/2020,460,4865,29,45,0,0,0,0,15,17,0,0,70,481,5325,551,0,0
50,4/4/2020,512,5242,29,45,0,0,0,0,15,20,0,0,52,377,5754,429,3,0
50,4/5/2020,543,5830,29,45,0,0,0,0,15,22,0,0,31,588,6373,619,2,0
50,4/6/2020,575,6161,28,45,0,0,0,0,15,23,0,0,32,331,6736,363,1,0
50,4/7/2020,608,6645,29,45,0,0,0,0,15,23,0,0,33,484,7253,517,0,0
50,4/8/2020,631,7001,35,50,0,0,0,0,15,23,0,0,23,356,7632,379,0,5
50,4/9/2020,680,7218,33,0,0,0,0,0,15,23,0,0,49,217,7898,266,0,-50
50,4/10/2020,713,7502,32,0,0,0,0,0,15,24,0,0,33,284,8215,317,1,0
50,4/11/2020,733,8063,77,0,0,0,0,0,15,25,0,0,20,561,8796,581,1,0
50,4/12/2020,754,8724,34,0,0,0,0,0,15,27,0,0,21,661,9478,682,2,0
50,4/13/2020,761,9275,33,0,0,0,0,0,15,28,0,0,7,551,10036,558,1,0
50,4/14/2020,770,9491,64,0,0,0,0,0,15,29,0,0,9,216,10261,225,1,0
50,4/15/2020,779,9913,63,0,0,0,0,0,15,30,0,0,9,422,10692,431,1,0
50,4/16/2020,792,10259,58,0,0,0,0,0,15,35,0,0,13,346,11051,359,5,0
50,4/17/2020,802,10813,32,0,0,0,0,0,15,35,0,0,10,554,11615,564,0,0
50,4/18/2020,813,11212,56,0,0,0,0,0,15,38,0,0,11,399,12025,410,3,0
50,4/19/2020,817,11450,53,0,0,0,0,0,15,38,0,0,4,238,12267,242,0,0
50,4/20/2020,820,11671,49,0,0,0,0,0,15,38,0,0,3,221,12491,224,0,0
50,4/21/2020,828,11767,41,0,0,0,0,0,0,40,0,0,8,96,12595,104,2,0
50,4/22/2020,831,12097,37,0,0,0,0,0,0,40,0,0,3,330,12928,333,0,0
50,4/23/2020,834,12420,44,0,0,0,0,0,0,43,0,0,3,323,13254,326,3,0
50,4/24/2020,843,12808,32,0,0,0,0,0,0,44,0,0,9,388,13651,397,1,0
50,4/25/2020,852,13270,37,0,0,0,0,0,0,46,0,0,9,462,14122,471,2,0
50,4/26/2020,855,13518,34,0,0,0,0,0,0,46,0,0,3,248,14373,251,0,0
50,4/27/2020,862,13819,33,0,0,0,0,0,0,47,0,0,7,301,14681,308,1,0
50,4/28/2020,862,13947,29,0,0,0,0,0,0,47,0,0,0,128,14809,128,0,0
50,4/29/2020,866,14155,26,0,0,0,0,0,0,47,0,0,4,208,15021,212,0,0
50,4/30/2020,879,14357,23,0,0,0,0,0,0,49,0,0,13,202,15236,215,2,0
50,5/1/2020,885,14930,19,0,0,0,0,0,0,50,0,0,6,573,15815,579,1,0
50,5/2/2020,896,15232,11,0,0,0,0,0,0,51,0,0,11,302,16128,313,1,0
50,5/3/2020,901,15570,19,0,0,0,0,0,0,52,0,0,5,338,16471,343,1,0
50,5/4/2020,906,15889,15,0,0,0,0,0,0,52,0,0,5,319,16795,324,0,0
50,5/5/2020,909,16065,33,0,2,0,0,0,0,52,0,0,3,176,16974,179,0,0
50,5/6/2020,914,16281,26,0,2,0,0,0,706,52,0,0,5,216,17195,221,0,0
50,5/7/2020,916,16690,14,0,2,0,0,0,718,53,0,0,2,409,17606,411,1,0
50,5/8/2020,918,17222,15,0,0,0,0,0,737,53,0,0,2,532,18140,534,0,0
50,5/9/2020,926,17690,21,0,0,0,0,0,744,53,0,0,8,468,18616,476,0,0
50,5/10/2020,926,18167,21,0,0,0,0,0,777,53,0,0,0,477,19093,477,0,0
50,5/11/2020,927,18797,14,0,0,0,0,0,785,53,0,0,1,630,19724,631,0,0
50,5/12/2020,929,19107,18,0,0,0,0,0,787,53,53,0,2,310,20036,312,0,0
50,5/13/2020,930,19708,17,0,0,0,0,0,789,53,53,0,1,601,20638,602,0,0
50,5/14/2020,931,20497,18,0,0,0,0,0,792,53,53,0,1,789,21428,790,0,0
50,5/15/2020,932,21237,17,0,0,0,0,0,796,53,53,0,1,740,22169,741,0,0
50,5/16/2020,940,22197,20,0,0,0,0,0,804,53,53,0,8,960,23137,968,0,0
50,5/17/2020,940,22974,14,0,0,0,0,0,810,54,54,0,0,777,23914,777,1,0
50,5/18/2020,944,23547,22,0,0,0,0,0,815,54,54,0,4,573,24491,577,0,0
50,5/19/2020,944,24114,24,0,0,0,0,0,820,54,54,0,0,567,25058,567,0,0
50,5/20/2020,944,24114,15,0,0,0,0,0,824,54,54,0,0,0,25058,0,0,0
50,5/21/2020,950,24751,14,0,0,0,0,0,827,54,54,0,6,637,25701,643,0,0
50,5/22/2020,952,24781,16,0,0,0,0,0,834,54,54,0,2,30,25733,32,0,0
50,5/23/2020,954,26470,21,0,0,0,0,0,837,54,54,0,2,1689,27424,1691,0,0
50,5/24/2020,956,27634,25,0,0,0,0,0,839,54,54,0,2,1164,28590,1166,0,0
50,5/25/2020,962,28707,19,0,0,0,0,0,843,54,54,0,6,1073,29669,1079,0,0
50,5/26/2020,967,29456,25,0,0,0,0,0,848,54,54,0,5,749,30423,754,0,0
50,5/27/2020,971,30028,21,0,0,0,0,0,849,54,54,0,4,572,30999,576,0,0
50,5/28/2020,974,30178,17,0,0,0,0,0,855,55,55,0,3,150,31152,153,1,0
50,5/29/2020,975,30910,14,0,0,0,0,0,859,55,55,0,1,732,31885,733,0,0
50,5/30/2020,977,31690,17,0,0,0,0,0,865,55,55,0,2,780,32667,782,0,0
50,5/31/2020,981,32989,18,0,0,0,0,0,873,55,55,0,4,1299,33970,1303,0,0
50,6/1/2020,983,34343,16,0,0,0,0,0,880,55,55,0,2,1354,35326,1356,0,0
50,6/2/2020,988,35631,10,0,0,0,0,0,879,55,55,0,5,1288,36619,1293,0,0
50,6/3/2020,990,36205,10,0,0,0,0,0,879,55,55,0,2,574,37195,576,0,0
50,6/4/2020,1026,36808,13,0,0,0,0,0,881,55,55,0,36,603,37834,639,0,0
50,6/5/2020,1027,38090,14,0,0,0,0,0,882,55,55,0,1,1282,39117,1283,0,0
50,6/6/2020,1046,39037,16,0,0,0,0,0,888,55,55,0,19,947,40083,966,0,0
50,6/7/2020,1063,40155,14,0,0,0,0,0,890,55,55,0,17,1118,41218,1135,0,0
50,6/8/2020,1075,41723,13,0,0,0,0,0,895,55,55,0,12,1568,42798,1580,0,0
50,6/9/2020,1084,43144,16,0,0,0,0,0,901,55,55,0,9,1421,44228,1430,0,0
50,6/10/2020,1095,44647,11,0,0,0,0,0,903,55,55,0,11,1503,45742,1514,0,0
50,6/11/2020,1110,46099,12,0,0,0,0,0,905,55,55,0,15,1452,47209,1467,0,0
50,6/12/2020,1119,47515,16,0,0,0,0,0,907,55,55,0,9,1416,48634,1425,0,0
50,6/13/2020,1125,48808,11,0,0,0,0,0,908,55,55,0,6,1293,49933,1299,0,0
50,6/14/2020,1127,49855,26,0,0,0,0,0,909,55,55,0,2,1047,50982,1049,0,0
50,6/15/2020,1128,51429,16,0,0,0,0,0,912,55,55,0,1,1574,52557,1575,0,0
50,6/16/2020,1131,51759,12,0,0,0,0,0,914,55,55,0,3,330,52890,333,0,0
50,6/17/2020,1130,52533,5,0,0,0,0,0,915,55,55,0,-1,774,53663,773,0,0
50,6/18/2020,1135,53610,11,0,0,0,0,0,917,56,56,0,5,1077,54745,1082,1,0
50,6/19/2020,1144,54743,8,0,0,0,0,0,918,56,56,0,9,1133,55887,1142,0,0
50,6/20/2020,1147,55881,9,0,0,0,0,0,920,56,56,0,3,1138,57028,1141,0,0
50,6/21/2020,1159,56686,11,0,0,0,0,0,922,56,56,0,12,805,57845,817,0,0
50,6/22/2020,1163,57444,8,0,0,0,0,0,926,56,56,0,4,758,58607,762,0,0
50,6/23/2020,1164,58164,19,0,0,0,0,0,927,56,56,0,1,720,59328,721,0,0
50,6/24/2020,1184,58676,13,0,0,0,0,0,930,56,56,0,20,512,59860,532,0,0
50,6/25/2020,1191,59518,15,0,0,0,0,0,938,56,56,0,7,842,60709,849,0,0
50,6/26/2020,1198,60391,14,0,0,0,0,0,941,56,56,0,7,873,61589,880,0,0
50,6/27/2020,1200,61523,14,0,0,0,0,0,946,56,56,0,2,1132,62723,1134,0,0
50,6/28/2020,1202,62663,15,0,0,0,0,0,946,56,56,0,2,1140,63865,1142,0,0
50,6/29/2020,1208,63785,13,0,0,0,0,0,949,56,56,0,6,1122,64993,1128,0,0
50,6/30/2020,1208,64556,16,0,0,0,0,0,953,56,56,0,0,771,65764,771,0,0
50,7/1/2020,1210,65082,17,0,0,0,0,0,961,56,56,0,2,526,66292,528,0,0
50,7/2/2020,1227,66114,21,0,0,0,0,0,960,56,56,0,17,1032,67341,1049,0,0
50,7/3/2020,1236,67159,16,0,0,0,0,0,967,56,56,0,9,1045,68395,1054,0,0
50,7/4/2020,1238,68159,16,0,0,0,0,0,999,56,56,0,2,1000,69397,1002,0,0
50,7/5/2020,1249,68775,15,0,0,0,0,0,1007,56,56,0,11,616,70024,627,0,0
50,7/6/2020,1251,69102,24,0,0,0,0,0,1022,56,56,0,2,327,70353,329,0,0
50,7/7/2020,1254,69859,13,0,0,0,0,0,1039,56,56,0,3,757,71113,760,0,0
50,7/8/2020,1256,70500,14,0,0,0,0,0,1049,56,56,0,2,641,71756,643,0,0
50,7/9/2020,1272,71477,15,0,0,0,0,0,1054,56,56,0,16,977,72749,993,0,0
50,7/10/2020,1277,72821,11,0,0,0,0,0,1066,56,56,0,5,1344,74098,1349,0,0
50,7/11/2020,1283,73749,18,0,0,0,0,0,1066,56,56,0,6,928,75032,934,0,0
50,7/12/2020,1296,74555,17,0,0,0,0,0,1089,56,56,0,13,806,75851,819,0,0
50,7/13/2020,1301,75280,10,0,0,0,0,0,1096,56,56,0,5,725,76581,730,0,0
50,7/14/2020,1305,76319,15,0,0,0,0,0,1099,56,56,0,4,1039,77624,1043,0,0
50,7/15/2020,1318,77040,19,0,0,0,0,0,1104,56,56,0,13,721,78358,734,0,0
50,7/16/2020,1325,77715,25,0,0,0,0,0,1111,56,56,0,7,675,79040,682,0,0
50,7/17/2020,1334,78032,33,0,0,0,0,0,1121,56,56,0,9,317,79366,326,0,0
49,3/7/2020,1,0,0,0,0,0,0,0,0,0,0,0,0,0,1,0,0,0
49,3/8/2020,1,0,0,0,0,0,0,0,0,0,0,0,0,0,1,0,0,0
49,3/9/2020,1,0,0,0,0,0,0,0,0,0,0,0,0,0,1,0,0,0
49,3/10/2020,2,0,0,0,0,0,0,0,0,0,0,0,1,0,2,1,0,0
49,3/11/2020,2,0,0,0,0,0,0,0,0,0,0,0,0,0,2,0,0,0
49,3/12/2020,4,131,0,0,0,0,0,0,0,0,0,0,2,131,135,133,0,0
49,3/13/2020,6,131,0,0,0,0,0,0,0,0,0,0,2,0,137,2,0,0
49,3/14/2020,6,131,0,0,0,0,0,0,0,0,0,0,0,0,137,0,0,0
49,3/15/2020,28,131,0,0,0,0,0,0,0,0,0,0,22,0,159,22,0,0
49,3/16/2020,39,131,0,0,0,0,0,0,0,0,0,0,11,0,170,11,0,0
49,3/17/2020,51,131,0,0,0,0,0,0,0,0,0,0,12,0,182,12,0,0
49,3/18/2020,63,131,0,0,0,0,0,0,0,0,0,0,12,0,194,12,0,0
49,3/19/2020,78,1448,0,0,0,0,0,0,0,0,0,0,15,1317,1526,1332,0,0
49,3/20/2020,112,2035,0,0,0,0,0,0,0,0,0,0,34,587,2147,621,0,0
49,3/21/2020,136,2424,0,0,0,0,0,0,0,0,0,0,24,389,2560,413,0,0
49,3/22/2020,181,3508,0,0,0,0,0,0,0,1,0,0,45,1084,3689,1129,1,0
49,3/23/2020,257,4790,0,0,0,0,0,0,0,1,0,0,76,1282,5047,1358,0,0
49,3/24/2020,299,5524,0,0,0,0,0,0,0,1,0,0,42,734,5823,776,0,0
49,3/25/2020,346,6491,0,0,0,0,0,0,0,1,0,0,47,967,6837,1014,0,0
49,3/26/2020,402,7308,0,0,0,0,0,0,0,1,0,0,56,817,7710,873,0,0
49,3/27/2020,480,8764,0,0,0,0,0,0,0,2,0,0,78,1456,9244,1534,1,0
49,3/28/2020,602,10710,0,0,0,0,0,0,0,2,0,0,122,1946,11312,2068,0,0
49,3/29/2020,719,13274,0,0,0,0,0,0,0,2,0,0,117,2564,13993,2681,0,0
49,3/30/2020,806,15197,0,0,0,0,0,0,0,4,0,0,87,1923,16003,2010,2,0
49,3/31/2020,887,17626,0,73,0,0,0,0,0,5,0,0,81,2429,18513,2510,1,73
49,4/1/2020,1012,20155,0,91,0,0,0,0,0,7,0,0,125,2529,21167,2654,2,18
49,4/2/2020,1074,20155,0,100,0,0,0,0,0,7,0,0,62,0,21229,62,0,9
49,4/3/2020,1246,23002,0,106,0,0,0,0,0,7,0,0,172,2847,24248,3019,0,6
49,4/4/2020,1428,26615,0,117,0,0,0,0,0,8,0,0,182,3613,28043,3795,1,11
49,4/5/2020,1605,29287,0,124,0,0,0,0,0,8,0,0,177,2672,30892,2849,0,7
49,4/6/2020,1675,31719,0,138,0,0,0,0,0,13,0,0,70,2432,33394,2502,5,14
49,4/7/2020,1738,32909,0,148,0,0,0,0,0,13,0,0,63,1190,34647,1253,0,10
49,4/8/2020,1846,34270,0,158,0,0,0,0,0,13,0,0,108,1361,36116,1469,0,10
49,4/9/2020,1976,36397,0,168,0,0,0,0,0,13,0,0,130,2127,38373,2257,0,10
49,4/10/2020,2102,38660,0,183,0,0,0,0,0,17,0,0,126,2263,40762,2389,4,15
49,4/11/2020,2206,40340,0,190,0,0,0,0,0,18,0,0,104,1680,42546,1784,1,7
49,4/12/2020,2303,41931,0,195,0,0,0,0,0,18,0,0,97,1591,44234,1688,0,5
49,4/13/2020,2363,43424,0,201,0,0,0,0,218,18,0,0,60,1493,45787,1553,0,6
49,4/14/2020,2412,44064,0,213,0,0,0,0,218,19,0,0,49,640,46476,689,1,12
49,4/15/2020,2542,45072,0,221,0,0,0,0,218,20,0,0,130,1008,47614,1138,1,8
49,4/16/2020,2683,46995,0,238,0,0,0,0,357,21,0,0,141,1923,49678,2064,1,17
49,4/17/2020,2805,52966,0,244,0,0,0,0,443,23,0,0,122,5971,55771,6093,2,6
49,4/18/2020,2931,57013,0,251,0,0,0,0,565,25,0,0,126,4047,59944,4173,2,7
49,4/19/2020,3069,60486,0,259,0,0,0,0,679,27,0,0,138,3473,63555,3611,2,8
49,4/20/2020,3213,65098,0,268,0,0,0,0,776,28,0,0,144,4612,68311,4756,1,9
49,4/21/2020,3296,69062,0,277,0,0,0,0,888,32,0,0,83,3964,72358,4047,4,9
49,4/22/2020,3445,73015,0,288,0,0,0,0,970,34,0,0,149,3953,76460,4102,2,11
49,4/23/2020,3612,77015,0,301,0,0,0,0,1050,35,0,0,167,4000,80627,4167,1,13
49,4/24/2020,3782,80915,0,315,0,0,0,0,1252,39,0,0,170,3900,84697,4070,4,14
49,4/25/2020,3948,86258,0,329,0,0,0,0,1399,41,0,0,166,5343,90206,5509,2,14
49,4/26/2020,4123,91579,0,345,0,0,0,0,1568,41,0,0,175,5321,95702,5496,0,16
49,4/27/2020,4233,95962,0,349,0,0,0,0,1641,41,0,0,110,4383,100195,4493,0,4
49,4/28/2020,4343,98096,0,370,0,0,0,0,1704,45,0,0,110,2134,102439,2244,4,21
49,4/29/2020,4495,101283,0,383,0,0,0,0,1790,45,0,0,152,3187,105778,3339,0,13
49,4/30/2020,4672,103829,0,390,0,0,0,0,1939,46,0,0,177,2546,108501,2723,1,7
49,5/1/2020,4828,107730,0,403,0,0,0,0,2062,46,0,0,156,3901,112558,4057,0,13
49,5/2/2020,4981,112823,0,418,0,0,0,0,2185,49,0,0,153,5093,117804,5246,3,15
49,5/3/2020,5175,116927,0,436,0,0,0,0,2238,50,0,0,194,4104,122102,4298,1,18
49,5/4/2020,5317,119344,0,441,0,0,0,0,2342,50,0,0,142,2417,124661,2559,0,5
49,5/5/2020,5449,121266,0,456,0,0,0,0,2387,56,0,0,132,1922,126715,2054,6,15
49,5/6/2020,5595,125407,0,464,0,0,0,0,2509,58,0,0,146,4141,131002,4287,2,8
49,5/7/2020,5724,128819,194,476,0,159,0,73,2640,61,0,0,129,3412,134543,3541,3,12
49,5/8/2020,5919,132769,216,488,0,162,0,73,2769,61,0,0,195,3950,138688,4145,0,12
49,5/9/2020,6103,137191,172,498,0,166,0,75,2901,66,0,0,184,4422,143294,4606,5,10
49,5/10/2020,6251,140259,144,512,0,168,0,76,3033,67,0,0,148,3068,146510,3216,1,14
49,5/11/2020,6362,144223,160,517,0,169,0,76,3181,68,0,0,111,3964,150585,4075,1,5
49,5/12/2020,6432,147053,166,535,0,178,0,80,3267,73,0,0,70,2830,153485,2900,5,18
49,5/13/2020,6620,150166,158,553,0,182,0,81,3406,75,0,0,188,3113,156786,3301,2,18
49,5/14/2020,6749,153370,142,558,0,187,0,83,3566,75,0,0,129,3204,160119,3333,0,5
49,5/15/2020,6913,156305,161,566,0,190,0,83,3719,77,0,0,164,2935,163218,3099,2,8
49,5/16/2020,7068,159706,168,578,0,194,0,84,3896,78,0,0,155,3401,166774,3556,1,12
49,5/17/2020,7238,163514,181,586,0,196,0,84,4075,80,0,0,170,3808,170752,3978,2,8
49,5/18/2020,7384,166638,179,595,0,197,0,84,4183,80,0,0,146,3124,174022,3270,0,9
49,5/19/2020,7518,169793,96,619,0,197,0,84,4275,88,0,0,134,3155,177311,3289,8,24
49,5/20/2020,7710,171954,144,631,0,200,0,87,4423,90,0,0,192,2161,179664,2353,2,12
49,5/21/2020,7874,175000,169,647,0,207,0,88,4596,92,0,0,164,3046,182874,3210,2,16
49,5/22/2020,8057,178777,163,660,0,210,0,88,4748,93,0,0,183,3777,186834,3960,1,13
49,5/23/2020,8260,182519,165,676,0,213,0,88,4898,97,0,0,203,3742,190779,3945,4,16
49,5/24/2020,8392,186041,128,688,0,215,0,88,5081,97,0,0,132,3522,194433,3654,0,12
49,5/25/2020,8521,187947,131,692,0,215,0,88,5218,98,0,0,129,1906,196468,2035,1,4
49,5/26/2020,8620,189972,134,696,0,217,0,89,5346,101,0,0,99,2025,198592,2124,3,4
49,5/27/2020,8706,191920,127,716,0,223,0,94,5499,105,0,0,86,1948,200626,2034,4,20
49,5/28/2020,8921,194586,169,734,0,231,0,98,5623,106,0,0,215,2666,203507,2881,1,18
49,5/29/2020,9264,196591,135,753,0,237,0,102,5813,107,0,0,343,2005,205855,2348,1,19
49,5/30/2020,9533,200572,139,763,0,241,0,102,5995,112,0,0,269,3981,210105,4250,5,10
49,5/31/2020,9797,204117,142,775,0,242,0,102,6137,113,0,0,264,3545,213914,3809,1,12
49,6/1/2020,9999,208113,134,789,0,242,0,102,6251,113,0,0,202,3996,218112,4198,0,14
49,6/2/2020,10202,211589,159,801,0,243,0,104,6319,113,0,0,203,3476,221791,3679,0,12
49,6/3/2020,10497,213484,150,829,0,250,0,107,6501,117,0,0,295,1895,223981,2190,4,28
49,6/4/2020,10813,216694,164,850,0,258,0,108,6628,117,0,0,316,3210,227507,3526,0,21
49,6/5/2020,11252,220945,133,870,0,262,0,109,6788,120,0,0,439,4251,232197,4690,3,20
49,6/6/2020,11798,223351,147,890,0,266,0,110,6939,121,0,0,546,2406,235149,2952,1,20
49,6/7/2020,12066,225885,207,900,0,269,0,111,7108,121,0,0,268,2534,237951,2802,0,10
49,6/8/2020,12322,230577,182,918,0,270,0,112,7255,124,0,0,256,4692,242899,4948,3,18
49,6/9/2020,12559,234301,230,931,0,274,0,116,7391,127,0,0,237,3724,246860,3961,3,13
49,6/10/2020,12864,236896,223,954,0,276,0,116,7587,128,0,0,305,2595,249760,2900,1,23
49,6/11/2020,13252,241416,188,968,0,282,0,123,7745,131,0,0,388,4520,254668,4908,3,14
49,6/12/2020,13577,245209,197,988,0,294,0,130,7935,139,0,0,325,3793,258786,4118,8,20
49,6/13/2020,13981,248801,236,1012,0,300,0,132,8114,139,0,0,404,3592,262782,3996,0,24
49,6/14/2020,14313,253400,178,1028,0,302,0,134,8252,139,0,0,332,4599,267713,4931,0,16
49,6/15/2020,14608,258330,184,1041,72,304,0,134,8380,143,0,0,295,4930,272938,5225,4,13
49,6/16/2020,14937,260763,271,1073,0,311,0,138,8470,145,0,0,329,2433,275700,2762,2,32
49,6/17/2020,15344,263348,270,1102,64,321,0,142,8552,149,0,0,407,2585,278692,2992,4,29
49,6/18/2020,15839,266846,282,1120,66,326,0,145,8786,152,0,0,495,3498,282685,3993,3,18
49,6/19/2020,16425,270933,237,1145,63,330,0,148,9113,155,0,0,586,4087,287358,4673,3,25
49,6/20/2020,17068,275809,232,1161,66,333,0,149,9390,155,0,0,643,4876,292877,5519,0,16
49,6/21/2020,17462,278933,222,1184,67,338,0,150,9659,158,0,0,394,3124,296395,3518,3,23
49,6/22/2020,17906,281406,198,1192,67,338,0,150,9863,158,0,0,444,2473,299312,2917,0,8
49,6/23/2020,18300,283976,214,1226,77,344,0,153,10057,163,0,0,394,2570,302276,2964,5,34
49,6/24/2020,18784,285954,245,1256,77,355,0,154,10334,163,0,0,484,1978,304738,2462,0,30
49,6/25/2020,19374,292680,230,1290,79,365,0,160,10642,164,0,0,590,6726,312054,7316,1,34
49,6/26/2020,20050,297518,238,1321,80,375,0,161,11097,166,0,0,676,4838,317568,5514,2,31
49,6/27/2020,20628,302174,287,1365,77,388,0,166,11658,167,0,0,578,4656,322802,5234,1,44
49,6/28/2020,21100,307349,289,1396,83,389,0,167,11931,167,0,0,472,5175,328449,5647,0,31
49,6/29/2020,21664,312241,254,1417,80,394,0,170,12205,168,0,0,564,4892,333905,5456,1,21
49,6/30/2020,22217,318536,250,1444,83,406,0,178,12398,172,0,0,553,6295,340753,6848,4,27
49,7/1/2020,22716,320642,261,1476,84,423,0,187,12707,173,0,0,499,2106,343358,2605,1,32
49,7/2/2020,23270,323116,229,1505,81,430,0,190,13076,176,0,0,554,2474,346386,3028,3,29
49,7/3/2020,23866,332770,232,1529,85,434,0,193,13408,181,0,0,596,9654,356636,10250,5,24
49,7/4/2020,24542,342174,255,1565,88,436,0,194,13807,181,0,0,676,9404,366716,10080,0,36
49,7/5/2020,24952,346356,237,1582,84,438,0,195,14147,184,0,0,410,4182,371308,4592,3,17
49,7/6/2020,25469,350373,244,1604,83,438,0,194,14448,190,0,0,517,4017,375842,4534,6,22
49,7/7/2020,26033,356816,248,1653,84,455,0,200,14764,194,0,0,564,6443,382849,7007,4,49
49,7/8/2020,26755,359005,236,1678,76,465,0,203,15178,201,0,0,722,2189,385760,2911,7,25
49,7/9/2020,27356,361377,207,1700,74,472,0,204,15661,205,0,0,601,2372,388733,2973,4,22
49,7/10/2020,28223,367751,229,1748,79,477,0,205,16261,207,0,0,867,6374,395974,7241,2,48
49,7/11/2020,28855,376497,269,1797,84,483,0,207,16897,212,0,0,632,8746,405352,9378,5,49
49,7/12/2020,29484,383574,276,1824,84,486,0,207,17303,215,0,0,629,7077,413058,7706,3,27
49,7/13/2020,30030,388305,252,1850,86,487,0,208,17728,216,0,0,546,4731,418335,5277,1,26
49,7/14/2020,30478,394043,231,1888,80,505,0,210,18111,226,0,0,448,5738,424521,6186,10,38
49,7/15/2020,30891,401189,250,1913,83,515,0,214,18593,233,0,0,413,7146,432080,7559,7,25
49,7/16/2020,31845,407683,236,1956,89,523,0,214,19214,234,0,0,954,6494,439528,7448,1,43
49,7/17/2020,32572,415234,256,1984,96,532,0,220,19862,235,0,0,727,7551,447806,8278,1,28
51,3/5/2020,0,18,0,0,0,0,0,0,0,0,0,0,0,0,18,0,0,0
51,3/6/2020,0,21,0,0,0,0,0,0,0,0,0,0,0,3,21,3,0,0
51,3/7/2020,0,31,0,0,0,0,0,0,0,0,0,0,0,10,31,10,0,0
51,3/8/2020,2,36,0,0,0,0,0,0,0,0,0,0,2,5,38,7,0,0
51,3/9/2020,3,38,0,0,0,0,0,0,0,0,0,0,1,2,41,3,0,0
51,3/10/2020,8,53,0,0,0,0,0,0,0,0,0,0,5,15,61,20,0,0
51,3/11/2020,9,60,0,0,0,0,0,0,0,0,0,0,1,7,69,8,0,0
51,3/12/2020,17,117,0,0,0,0,0,0,0,0,0,0,8,57,134,65,0,0
51,3/13/2020,30,117,0,0,0,0,0,0,0,0,0,0,13,0,147,13,0,0
51,3/14/2020,30,117,0,0,0,0,0,0,0,0,0,0,0,0,147,0,0,0
51,3/15/2020,45,363,0,0,0,0,0,0,0,1,0,0,15,246,408,261,1,0
51,3/16/2020,51,438,0,0,0,0,0,0,0,1,0,0,6,75,489,81,0,0
51,3/17/2020,67,961,0,0,0,0,0,0,0,1,0,0,16,523,1028,539,0,0
51,3/18/2020,77,1201,0,0,0,0,0,0,0,1,0,0,10,240,1278,250,0,0
51,3/19/2020,94,1829,0,0,0,0,0,0,0,2,0,0,17,628,1923,645,1,0
51,3/20/2020,114,2211,0,0,0,0,0,0,0,2,0,0,20,382,2325,402,0,0
51,3/21/2020,152,2638,0,25,0,0,0,0,0,2,0,0,38,427,2790,465,0,25
51,3/22/2020,219,3118,0,32,0,0,0,0,0,3,0,0,67,480,3337,547,1,7
51,3/23/2020,254,3443,0,38,0,0,0,0,0,6,0,0,35,325,3697,360,3,6
51,3/24/2020,290,4180,0,45,0,0,0,0,0,7,0,0,36,737,4470,773,1,7
51,3/25/2020,391,4979,0,59,0,0,0,0,0,9,0,0,101,799,5370,900,2,14
51,3/26/2020,460,5729,0,65,0,0,0,0,0,13,0,0,69,750,6189,819,4,6
51,3/27/2020,604,6733,0,83,0,0,0,0,0,14,0,0,144,1004,7337,1148,1,18
51,3/28/2020,739,8427,0,99,0,0,0,0,0,17,0,0,135,1694,9166,1829,3,16
51,3/29/2020,890,9719,0,112,0,0,0,0,0,22,0,0,151,1292,10609,1443,5,13
51,3/30/2020,1020,11018,0,136,0,0,0,0,0,25,0,0,130,1299,12038,1429,3,24
51,3/31/2020,1250,12151,0,165,0,0,0,0,0,27,0,0,230,1133,13401,1363,2,29
51,4/1/2020,1484,13860,0,305,0,145,0,108,0,34,0,0,234,1709,15344,1943,7,140
51,4/2/2020,1706,15883,246,305,0,145,0,108,0,41,0,0,222,2023,17589,2245,7,0
51,4/3/2020,2012,16993,0,312,0,145,0,108,0,46,0,0,306,1110,19005,1416,5,7
51,4/4/2020,2407,19145,0,390,0,145,0,108,0,52,0,0,395,2152,21552,2547,6,78
51,4/5/2020,2637,21034,0,431,0,145,0,108,0,51,0,0,230,1889,23671,2119,-1,41
51,4/6/2020,2878,21643,0,497,0,145,0,108,0,54,0,0,241,609,24521,850,3,66
51,4/7/2020,3333,25312,0,563,0,145,0,108,0,63,0,0,455,3669,28645,4124,9,66
51,4/8/2020,3645,27000,0,615,0,145,0,108,0,75,0,0,312,1688,30645,2000,12,52
51,4/9/2020,4042,28984,669,685,469,0,285,0,0,109,0,0,397,1984,33026,2381,34,70
51,4/10/2020,4509,30950,1238,772,457,0,287,0,0,121,0,0,467,1966,35459,2433,12,87
51,4/11/2020,5077,32922,1252,0,426,0,283,0,0,130,0,0,568,1972,37999,2540,9,-772
51,4/12/2020,5274,34711,751,0,440,0,294,0,0,141,0,0,197,1789,39985,1986,11,0
51,4/13/2020,5747,35654,1238,0,428,0,302,0,0,149,0,0,473,943,41401,1416,8,0
51,4/14/2020,6171,36592,1282,0,422,0,276,0,721,154,0,0,424,938,42763,1362,5,0
51,4/15/2020,6500,37669,1298,1048,394,0,234,0,752,195,0,0,329,1077,44169,1406,41,1048
51,4/16/2020,6889,39555,1337,1114,427,0,238,0,951,208,0,0,389,1886,46444,2275,13,66
51,4/17/2020,7491,41506,1308,1221,400,0,224,0,1110,231,0,0,602,1951,48997,2553,23,107
51,4/18/2020,8053,43878,1307,1296,398,0,230,0,1228,258,0,0,562,2372,51931,2934,27,75
51,4/19/2020,8537,46196,1319,1422,388,0,231,0,1267,277,0,0,484,2318,54733,2802,19,126
51,4/20/2020,8990,47745,1296,1500,396,0,237,0,1324,300,0,0,453,1549,56735,2002,23,78
51,4/21/2020,9630,48724,1331,1581,403,0,251,0,1418,324,321,3,640,979,58354,1619,24,81
51,4/22/2020,10266,50512,1374,1659,419,0,244,0,1497,349,347,2,636,1788,60778,2424,25,78
51,4/23/2020,10998,53891,1379,1753,400,0,249,0,1567,372,370,2,732,3379,64889,4111,23,94
51,4/24/2020,11594,57846,1399,1837,379,0,220,0,1672,410,407,3,596,3955,69440,4551,38,84
51,4/25/2020,12366,60276,1405,1942,357,0,223,0,1717,436,432,4,772,2430,72642,3202,26,105
51,4/26/2020,12970,63630,1436,2014,387,0,217,0,1815,448,444,4,604,3354,76600,3958,12,72
51,4/27/2020,13535,67144,1455,3298,389,0,217,0,1843,458,454,4,565,3514,80679,4079,10,1284
51,4/28/2020,14339,68959,1508,3422,376,0,217,0,1914,492,487,5,804,1815,83298,2619,34,124
51,4/29/2020,14961,70979,1566,3608,387,0,222,0,2042,522,513,9,622,2020,85940,2642,30,186
51,4/30/2020,15846,75663,1550,3654,372,0,208,0,2104,552,543,9,885,4684,91509,5569,30,46
51,5/1/2020,16901,89539,1431,3654,366,0,193,0,2196,581,572,9,1055,13876,106440,14931,29,0
51,5/2/2020,17731,84365,1426,3738,375,0,202,0,2312,616,607,9,830,-5174,102096,-4344,35,84
51,5/3/2020,18671,89331,1413,3910,385,0,193,0,2497,660,644,16,940,4966,108002,5906,44,172
51,5/4/2020,19492,92801,1463,4010,348,0,192,0,2547,684,662,22,821,3470,112293,4291,24,100
51,5/5/2020,20256,93452,1496,4113,361,0,189,0,2617,713,690,23,764,651,113708,1415,29,103
51,5/6/2020,20256,93452,1496,4113,361,0,189,0,2617,713,690,23,0,0,113708,0,0,0
51,5/7/2020,21570,101582,1613,4438,371,0,203,0,2825,769,745,24,1314,8130,123152,9444,56,325
51,5/8/2020,22342,107603,1625,4622,378,0,199,0,2997,812,787,25,772,6021,129945,6793,43,184
51,5/9/2020,23196,113953,1593,4717,367,0,198,0,3124,827,801,26,854,6350,137149,7204,15,95
51,5/10/2020,24081,118974,1555,4756,351,0,187,0,3201,839,813,26,885,5021,143055,5906,12,39
51,5/11/2020,25070,125547,1504,4777,362,0,194,0,3273,850,823,27,989,6573,150617,7562,11,21
51,5/12/2020,25800,129529,1529,4929,364,0,201,0,3400,891,864,27,730,3982,155329,4712,41,152
51,5/13/2020,26746,134646,1526,5080,374,0,202,0,3554,927,899,28,946,5117,161392,6063,36,151
51,5/14/2020,27813,139017,1533,5211,355,0,201,0,3678,955,927,28,1067,4371,166830,5438,28,131
51,5/15/2020,28672,149342,1511,5316,362,0,195,0,3805,977,944,33,859,10325,178014,11184,22,105
51,5/16/2020,29683,155885,1505,5414,381,0,189,0,3909,1002,968,34,1011,6543,185568,7554,25,98
51,5/17/2020,30388,159973,1524,5517,379,0,195,0,3993,1009,975,34,705,4088,190361,4793,7,103
51,5/18/2020,31140,165086,1502,5609,361,0,194,0,4107,1014,980,34,752,5113,196226,5865,5,92
51,5/19/2020,32145,170644,1497,5768,377,0,199,0,4271,1041,1007,34,1005,5558,202789,6563,27,159
51,5/20/2020,32908,179718,1536,6059,370,0,202,0,4523,1074,1040,34,763,9074,212626,9837,33,291
51,5/21/2020,34137,184462,1491,6269,351,0,191,0,4778,1099,1064,35,1229,4744,218599,5973,25,210
51,5/22/2020,34950,190225,1459,6422,366,0,207,0,4963,1136,1100,36,813,5763,225175,6576,37,153
51,5/23/2020,35749,196721,1384,6431,330,0,213,0,5047,1159,1123,36,799,6496,232470,7295,23,9
51,5/24/2020,36244,207841,1351,6453,354,0,192,0,5102,1171,1135,36,495,11120,244085,11615,12,22
51,5/25/2020,37727,221023,1376,6521,349,0,182,0,5145,1208,1158,50,1483,13182,258750,14665,37,68
51,5/26/2020,39342,227839,1403,6630,366,0,190,0,5227,1236,1175,61,1615,6816,267181,8431,28,109
51,5/27/2020,40249,236798,1459,6826,390,0,203,0,5367,1281,1202,79,907,8959,277047,9866,45,196
51,5/28/2020,41401,245880,1502,6974,416,0,195,0,5472,1338,1236,102,1152,9082,287281,10234,57,148
51,5/29/2020,42533,255844,1524,7172,373,0,193,0,5648,1358,1258,100,1132,9964,298377,11096,20,198
51,5/30/2020,43611,261901,1471,7216,372,0,194,0,5745,1370,1269,101,1078,6057,305512,7135,12,44
51,5/31/2020,44607,270784,1458,7326,371,0,196,0,5868,1375,1274,101,996,8883,315391,9879,5,110
51,6/1/2020,45398,279321,1371,7326,347,0,188,0,5899,1392,1282,110,791,8537,324719,9328,17,0
51,6/2/2020,46239,282650,1362,7373,336,0,186,0,6011,1407,1300,107,841,3329,328889,4170,15,47
51,6/3/2020,46905,295482,1311,7476,313,0,185,0,6165,1428,1322,106,666,12832,342387,13498,21,103
51,6/4/2020,47856,305734,1266,7550,321,0,171,0,6284,1445,1338,107,951,10252,353590,11203,17,74
51,6/5/2020,48532,315238,1205,7597,320,0,161,0,6392,1453,1350,103,676,9504,363770,10180,8,47
51,6/6/2020,49397,321734,1171,7553,324,0,169,0,6382,1460,1357,103,865,6496,371131,7361,7,-44
51,6/7/2020,50681,329135,1186,7724,316,0,165,0,6538,1472,1369,103,1284,7401,379816,8685,12,171
51,6/8/2020,51251,332341,1173,7730,308,0,160,0,6557,1477,1373,104,570,3206,383592,3776,5,6
51,6/9/2020,51738,339118,1169,7846,311,0,155,0,6677,1496,1391,105,487,6777,390856,7264,19,116
51,6/10/2020,52177,346187,1155,7981,296,0,139,0,6826,1514,1408,106,439,7069,398364,7508,18,135
51,6/11/2020,52647,354750,1069,7964,273,0,138,0,6895,1520,1413,107,470,8563,407397,9033,6,-17
51,6/12/2020,53211,397319,1026,8028,297,0,143,0,7002,1534,1426,108,564,42569,450530,43133,14,64
51,6/13/2020,53869,406124,959,8090,295,0,142,0,7131,1541,1435,106,658,8805,459993,9463,7,62
51,6/14/2020,54506,414494,958,8136,334,0,155,0,7178,1546,1438,108,637,8370,469000,9007,5,46
51,6/15/2020,54886,424113,902,8132,269,0,130,0,7230,1552,1444,108,380,9619,478999,9999,6,-4
51,6/16/2020,55331,430107,904,8245,241,0,125,0,7341,1570,1465,105,445,5994,485438,6439,18,113
51,6/17/2020,55775,438566,938,8367,249,0,120,0,7429,1583,1478,105,444,8459,494341,8903,13,122
51,6/18/2020,56238,445830,857,8350,241,0,129,0,7493,1586,1482,104,463,7264,502068,7727,3,-17
51,6/19/2020,56793,455618,862,8425,251,0,121,0,7563,1602,1499,103,555,9788,512411,10343,16,75
51,6/20/2020,57443,473961,880,8487,267,0,133,0,7607,1607,1504,103,650,18343,531404,18993,5,62
51,6/21/2020,57994,487682,863,8509,243,0,125,0,7646,1611,1508,103,551,13721,545676,14272,4,22
51,6/22/2020,58465,499658,848,8511,240,0,132,0,7663,1620,1517,103,471,11976,558123,12447,9,2
51,6/23/2020,58994,509383,847,8572,245,0,126,0,7725,1645,1542,103,529,9725,568377,10254,25,61
51,6/24/2020,59514,517057,886,8651,235,0,107,0,7765,1661,1559,102,520,7674,576571,8194,16,79
51,6/25/2020,59946,533020,854,8672,237,0,104,0,7818,1675,1572,103,432,15963,592966,16395,14,21
51,6/26/2020,60570,545893,854,8722,219,0,99,0,7868,1700,1596,104,624,12873,606463,13497,25,50
51,6/27/2020,61247,556679,819,8787,234,0,103,0,7968,1724,1620,104,677,10786,617926,11463,24,65
51,6/28/2020,61736,566592,818,8823,235,0,107,0,8005,1732,1628,104,489,9913,628328,10402,8,36
51,6/29/2020,62189,574183,796,8823,225,0,101,0,8023,1740,1635,105,453,7591,636372,8044,8,0
51,6/30/2020,62787,582247,902,8982,230,0,98,0,8080,1763,1658,105,598,8064,645034,8662,23,159
51,7/1/2020,63203,595430,892,9023,205,0,95,0,8131,1786,1681,105,416,13183,658633,13599,23,41
51,7/2/2020,63735,610521,888,9384,206,0,95,0,8496,1816,1712,104,532,15091,674256,15623,30,361
51,7/3/2020,64393,623967,818,9529,207,0,95,0,8711,1845,1741,104,658,13446,688360,14104,29,145
51,7/4/2020,65109,634120,808,9549,207,0,99,0,8741,1849,1745,104,716,10153,699229,10869,4,20
51,7/5/2020,65748,643607,792,9576,202,0,95,0,8784,1853,1746,107,639,9487,709355,10126,4,27
51,7/6/2020,66102,649011,783,9592,194,0,86,0,8809,1853,1747,106,354,5404,715113,5758,0,16
51,7/7/2020,66740,661377,902,9815,221,0,105,0,8913,1881,1775,106,638,12366,728117,13004,28,223
51,7/8/2020,67375,670624,971,9982,230,0,98,0,9011,1905,1799,106,635,9247,737999,9882,24,167
51,7/9/2020,67988,685440,956,10021,215,0,93,0,9065,1937,1832,105,613,14816,753428,15429,32,39
51,7/10/2020,68931,699794,1006,10195,234,0,102,0,9189,1958,1853,105,943,14354,768725,15297,21,174
51,7/11/2020,69782,716553,1020,10291,230,0,97,0,9271,1962,1857,105,851,16759,786335,17610,4,96
51,7/12/2020,70670,733375,1045,10355,228,0,101,0,9310,1966,1859,107,888,16822,804045,17710,4,64
51,7/13/2020,71642,742373,1129,10459,243,0,105,0,9330,1968,1861,107,972,8998,814015,9970,2,104
51,7/14/2020,72443,758407,1127,10550,249,0,112,0,9423,1977,1870,107,801,16034,830850,16835,9,91
51,7/15/2020,73527,771455,1081,10608,246,0,113,0,9527,1992,1882,110,1084,13048,844982,14132,15,58
51,7/16/2020,74431,786742,1134,10778,248,0,118,0,9644,2007,1903,104,904,15287,861173,16191,15,170
51,7/17/2020,75433,801271,1171,11054,247,0,118,0,9883,2013,1909,104,1002,14529,876704,15531,6,276
53,1/22/2020,2,0,0,0,0,0,0,0,0,0,0,0,0,0,2,0,0,0
53,1/23/2020,2,0,0,0,0,0,0,0,0,0,0,0,0,0,2,0,0,0
53,1/24/2020,2,0,0,0,0,0,0,0,0,0,0,0,0,0,2,0,0,0
53,1/25/2020,2,0,0,0,0,0,0,0,0,0,0,0,0,0,2,0,0,0
53,1/26/2020,2,0,0,0,0,0,0,0,0,0,0,0,0,0,2,0,0,0
53,1/27/2020,2,0,0,0,0,0,0,0,0,0,0,0,0,0,2,0,0,0
53,1/28/2020,2,0,0,0,0,0,0,0,0,0,0,0,0,0,2,0,0,0
53,1/29/2020,3,0,0,0,0,0,0,0,0,0,0,0,1,0,3,1,0,0
53,1/30/2020,3,0,0,0,0,0,0,0,0,0,0,0,0,0,3,0,0,0
53,1/31/2020,3,0,0,0,0,0,0,0,0,0,0,0,0,0,3,0,0,0
53,2/1/2020,4,0,0,0,0,0,0,0,0,0,0,0,1,0,4,1,0,0
53,2/2/2020,6,0,0,0,0,0,0,0,0,0,0,0,2,0,6,2,0,0
53,2/3/2020,7,0,0,0,0,0,0,0,0,0,0,0,1,0,7,1,0,0
53,2/4/2020,8,0,0,0,0,0,0,0,0,0,0,0,1,0,8,1,0,0
53,2/5/2020,8,0,0,0,0,0,0,0,0,0,0,0,0,0,8,0,0,0
53,2/6/2020,11,0,0,0,0,0,0,0,0,0,0,0,3,0,11,3,0,0
53,2/7/2020,12,0,0,0,0,0,0,0,0,0,0,0,1,0,12,1,0,0
53,2/8/2020,13,0,0,0,0,0,0,0,0,0,0,0,1,0,13,1,0,0
53,2/9/2020,13,0,0,0,0,0,0,0,0,0,0,0,0,0,13,0,0,0
53,2/10/2020,16,0,0,0,0,0,0,0,0,0,0,0,3,0,16,3,0,0
53,2/11/2020,17,0,0,0,0,0,0,0,0,0,0,0,1,0,17,1,0,0
53,2/12/2020,18,0,0,0,0,0,0,0,0,0,0,0,1,0,18,1,0,0
53,2/13/2020,18,0,0,0,0,0,0,0,0,0,0,0,0,0,18,0,0,0
53,2/14/2020,21,0,0,0,0,0,0,0,0,0,0,0,3,0,21,3,0,0
53,2/15/2020,28,0,0,0,0,0,0,0,0,0,0,0,7,0,28,7,0,0
53,2/16/2020,35,0,0,0,0,0,0,0,0,0,0,0,7,0,35,7,0,0
53,2/17/2020,50,0,0,0,0,0,0,0,0,0,0,0,15,0,50,15,0,0
53,2/18/2020,59,0,0,0,0,0,0,0,0,0,0,0,9,0,59,9,0,0
53,2/19/2020,69,0,0,0,0,0,0,0,0,0,0,0,10,0,69,10,0,0
53,2/20/2020,82,0,0,0,0,0,0,0,0,0,0,0,13,0,82,13,0,0
53,2/21/2020,93,0,0,0,0,0,0,0,0,0,0,0,11,0,93,11,0,0
53,2/22/2020,106,0,0,0,0,0,0,0,0,0,0,0,13,0,106,13,0,0
53,2/23/2020,122,0,0,0,0,0,0,0,0,0,0,0,16,0,122,16,0,0
53,2/24/2020,148,0,0,0,0,0,0,0,0,0,0,0,26,0,148,26,0,0
53,2/25/2020,179,0,0,0,0,0,0,0,0,0,0,0,31,0,179,31,0,0
53,2/26/2020,208,0,0,0,0,0,0,0,0,2,0,0,29,0,208,29,2,0
53,2/27/2020,235,0,0,0,0,0,0,0,0,2,0,0,27,0,235,27,0,0
53,2/28/2020,275,0,0,0,0,0,0,0,0,4,0,0,40,0,275,40,2,0
53,2/29/2020,299,17,0,0,0,0,0,0,0,5,0,0,24,17,316,41,1,0
53,3/1/2020,377,12,0,0,0,0,0,0,0,8,0,0,78,-5,389,73,3,0
53,3/2/2020,450,123,0,0,0,0,0,0,0,11,0,0,73,111,573,184,3,0
53,3/3/2020,534,264,0,0,0,0,0,0,0,14,0,0,84,141,798,225,3,0
53,3/4/2020,626,417,0,0,0,0,0,0,0,16,0,0,92,153,1043,245,2,0
53,3/5/2020,731,672,0,0,0,0,0,0,0,20,0,0,105,255,1403,360,4,0
53,3/6/2020,813,1066,0,0,0,0,0,0,0,26,0,0,82,394,1879,476,6,0
53,3/7/2020,912,1370,0,0,0,0,0,0,0,27,0,0,99,304,2282,403,1,0
53,3/8/2020,1065,1740,0,0,0,0,0,0,0,31,0,0,153,370,2805,523,4,0
53,3/9/2020,1237,2592,0,0,0,0,0,0,0,35,0,0,172,852,3829,1024,4,0
53,3/10/2020,1453,4160,0,0,0,0,0,0,0,37,0,0,216,1568,5613,1784,2,0
53,3/11/2020,1665,6215,0,0,0,0,0,0,0,40,0,0,212,2055,7880,2267,3,0
53,3/12/2020,1921,9723,0,0,0,0,0,0,0,44,0,0,256,3508,11644,3764,4,0
53,3/13/2020,2218,13660,0,0,0,0,0,0,0,47,0,0,297,3937,15878,4234,3,0
53,3/14/2020,2484,15723,0,0,0,0,0,0,0,51,0,0,266,2063,18207,2329,4,0
53,3/15/2020,2738,17158,0,0,0,0,0,0,0,57,0,0,254,1435,19896,1689,6,0
53,3/16/2020,3107,21684,0,0,0,0,0,0,0,69,0,0,369,4526,24791,4895,12,0
53,3/17/2020,3432,25997,0,0,0,0,0,0,0,78,0,0,325,4313,29429,4638,9,0
53,3/18/2020,3810,30359,0,0,0,0,0,0,0,82,0,0,378,4362,34169,4740,4,0
53,3/19/2020,4146,34573,0,0,0,0,0,0,0,92,0,0,336,4214,38719,4550,10,0
53,3/20/2020,4551,38229,0,0,0,0,0,0,0,104,0,0,405,3656,42780,4061,12,0
53,3/21/2020,4837,40285,0,0,0,0,0,0,0,111,0,0,286,2056,45122,2342,7,0
53,3/22/2020,5121,41889,0,0,0,0,0,0,0,126,0,0,284,1604,47010,1888,15,0
53,3/23/2020,5568,46745,0,0,0,0,0,0,0,137,0,0,447,4856,52313,5303,11,0
53,3/24/2020,5923,51617,0,0,0,0,0,0,0,146,0,0,355,4872,57540,5227,9,0
53,3/25/2020,6329,56218,0,0,0,0,0,0,0,159,0,0,406,4601,62547,5007,13,0
53,3/26/2020,6700,60318,0,0,0,0,0,0,0,183,0,0,371,4100,67018,4471,24,0
53,3/27/2020,7076,64302,0,0,0,0,0,0,0,199,0,0,376,3984,71378,4360,16,0
53,3/28/2020,7397,66582,0,0,0,0,0,0,0,220,0,0,321,2280,73979,2601,21,0
53,3/29/2020,7715,68097,0,0,0,0,0,0,0,237,0,0,318,1515,75812,1833,17,0
53,3/30/2020,8120,72842,0,0,0,0,0,0,0,248,0,0,405,4745,80962,5150,11,0
53,3/31/2020,8431,77237,0,0,0,0,0,0,0,262,0,0,311,4395,85668,4706,14,0
53,4/1/2020,8869,81516,0,0,0,0,0,0,0,282,0,0,438,4279,90385,4717,20,0
53,4/2/2020,9201,86091,0,0,0,0,0,0,0,310,0,0,332,4575,95292,4907,28,0
53,4/3/2020,9485,90661,0,0,0,0,0,0,0,338,0,0,284,4570,100146,4854,28,0
53,4/4/2020,9732,93028,574,0,174,0,0,0,0,365,0,0,247,2367,102760,2614,27,0
53,4/5/2020,9953,94759,581,0,178,0,0,0,0,386,0,0,221,1731,104712,1952,21,0
53,4/6/2020,10282,99566,638,0,191,0,0,0,0,407,0,0,329,4807,109848,5136,21,0
53,4/7/2020,10547,104530,641,0,190,0,0,0,0,429,0,0,265,4964,115077,5229,22,0
53,4/8/2020,10831,109050,655,0,186,0,0,0,0,443,0,0,284,4520,119881,4804,14,0
53,4/9/2020,11118,113069,650,0,191,0,0,0,0,459,0,0,287,4019,124187,4306,16,0
53,4/10/2020,11395,117091,642,0,191,0,0,0,0,476,0,0,277,4022,128486,4299,17,0
53,4/11/2020,11605,118957,649,0,191,0,0,0,0,494,0,0,210,1866,130562,2076,18,0
53,4/12/2020,11775,120218,642,0,191,0,0,0,0,509,0,0,170,1261,131993,1431,15,0
53,4/13/2020,12079,124134,527,0,166,0,0,0,0,526,0,0,304,3916,136213,4220,17,0
53,4/14/2020,12303,128219,387,0,98,0,0,0,0,542,0,0,224,4085,140522,4309,16,0
53,4/15/2020,12619,132049,645,0,194,0,0,0,0,551,0,0,316,3830,144668,4146,9,0
53,4/16/2020,12872,136144,595,0,196,0,0,0,0,571,0,0,253,4095,149016,4348,20,0
53,4/17/2020,13174,140294,622,0,195,0,0,0,0,585,0,0,302,4150,153468,4452,14,0
53,4/18/2020,13407,142307,518,0,155,0,0,0,0,598,0,0,233,2013,155714,2246,13,0
53,4/19/2020,13583,143808,586,0,193,0,0,0,0,615,0,0,176,1501,157391,1677,17,0
53,4/20/2020,13890,147889,403,0,122,0,0,0,0,629,0,0,307,4081,161779,4388,14,0
53,4/21/2020,14133,151848,503,0,161,0,0,0,0,640,0,0,243,3959,165981,4202,11,0
53,4/22/2020,14375,156030,543,0,161,0,0,0,0,647,0,0,242,4182,170405,4424,7,0
53,4/23/2020,14628,160115,544,0,151,0,0,0,0,654,0,0,253,4085,174743,4338,7,0
53,4/24/2020,14913,165339,551,0,164,0,0,0,0,659,0,0,285,5224,180252,5509,5,0
53,4/25/2020,15110,168153,455,0,174,0,0,0,0,665,0,0,197,2814,183263,3011,6,0
53,4/26/2020,15292,169749,508,0,145,0,0,0,0,738,0,0,182,1596,185041,1778,73,0
53,4/27/2020,15566,174592,536,0,115,0,0,0,0,749,0,0,274,4843,190158,5117,11,0
53,4/28/2020,15798,179707,436,0,158,0,0,0,0,765,0,0,232,5115,195505,5347,16,0
53,4/29/2020,16042,184386,490,0,156,0,0,0,0,786,0,0,244,4679,200428,4923,21,0
53,4/30/2020,16309,189001,474,0,145,0,0,0,0,801,0,0,267,4615,205310,4882,15,0
53,5/1/2020,16653,193449,470,0,120,0,0,0,0,814,0,0,344,4448,210102,4792,13,0
53,5/2/2020,16802,195619,428,0,117,0,0,0,0,824,0,0,149,2170,212421,2319,10,0
53,5/3/2020,16943,196962,411,0,120,0,0,0,0,830,0,0,141,1343,213905,1484,6,0
53,5/4/2020,17209,202206,263,0,86,0,0,0,0,834,0,0,266,5244,219415,5510,4,0
53,5/5/2020,17470,207014,292,0,102,0,0,0,0,841,0,0,261,4808,224484,5069,7,0
53,5/6/2020,17718,212065,390,0,127,0,0,0,0,862,0,0,248,5051,229783,5299,21,0
53,5/7/2020,17914,216453,358,0,144,0,0,0,0,870,0,0,196,4388,234367,4584,8,0
53,5/8/2020,18124,221418,393,0,122,0,0,0,0,891,0,0,210,4965,239542,5175,21,0
53,5/9/2020,18275,223361,393,0,128,0,0,0,0,905,0,0,151,1943,241636,2094,14,0
53,5/10/2020,18449,224548,335,0,101,0,0,0,0,921,0,0,174,1187,242997,1361,16,0
53,5/11/2020,18741,229099,350,0,110,0,0,0,0,931,0,0,292,4551,247840,4843,10,0
53,5/12/2020,18952,233864,321,0,94,0,0,0,0,945,945,0,211,4765,252816,4976,14,0
53,5/13/2020,19179,238384,384,0,114,0,0,0,0,962,962,0,227,4520,257563,4747,17,0
53,5/14/2020,19424,243144,365,0,111,0,0,0,0,975,975,0,245,4760,262568,5005,13,0
53,5/15/2020,19650,248322,374,0,114,0,0,0,0,983,983,0,226,5178,267972,5404,8,0
53,5/16/2020,19838,250963,331,0,90,0,0,0,0,992,992,0,188,2641,270801,2829,9,0
53,5/17/2020,19991,252780,168,0,52,0,0,0,0,1000,1000,0,153,1817,272771,1970,8,0
53,5/18/2020,20286,259467,168,0,52,0,0,0,0,1001,1001,0,295,6687,279753,6982,1,0
53,5/19/2020,20535,266314,168,0,52,0,0,0,0,1002,1002,0,249,6847,286849,7096,1,0
53,5/20/2020,20784,271703,168,0,52,0,0,0,0,1031,1031,0,249,5389,292487,5638,29,0
53,5/21/2020,20988,276171,242,3125,0,0,70,0,0,1037,1037,0,204,4468,297159,4672,6,3125
53,5/22/2020,21283,280444,332,3156,0,0,85,0,0,1044,1044,0,295,4273,301727,4568,7,31
53,5/23/2020,21492,282906,332,3230,0,0,96,0,0,1050,1050,0,209,2462,304398,2671,6,74
53,5/24/2020,21652,285088,313,3256,0,0,74,0,0,1055,1055,0,160,2182,306740,2342,5,26
53,5/25/2020,21909,287314,207,3287,0,0,47,0,0,1061,1061,0,257,2226,309223,2483,6,31
53,5/26/2020,22184,293934,267,3290,0,0,51,0,0,1070,1070,0,275,6620,316118,6895,9,3
53,5/27/2020,22483,299378,241,3338,0,0,53,0,0,1078,1078,0,299,5444,321861,5743,8,48
53,5/28/2020,22753,304340,325,3394,0,0,94,0,0,1095,1095,0,270,4962,327093,5232,17,56
53,5/29/2020,23047,309438,317,3413,0,0,85,0,0,1106,1106,0,294,5098,332485,5392,11,19
53,5/30/2020,23275,312508,319,3455,0,0,88,0,0,1111,1111,0,228,3070,335783,3298,5,42
53,5/31/2020,23456,314671,266,3480,0,0,67,0,0,1118,1118,0,181,2163,338127,2344,7,25
53,6/1/2020,23798,320527,245,3501,0,0,52,0,0,1118,1118,0,342,5856,344325,6198,0,21
53,6/2/2020,24086,326646,232,3517,0,0,48,0,0,1124,1124,0,288,6119,350732,6407,6,16
53,6/3/2020,24385,331675,263,3543,0,0,89,0,0,1129,1129,0,299,5029,356060,5328,5,26
53,6/4/2020,24677,335972,272,3578,0,0,94,0,0,1135,1135,0,292,4297,360649,4589,6,35
53,6/5/2020,25023,341885,285,3615,0,0,91,0,0,1138,1138,0,346,5913,366908,6259,3,37
53,6/6/2020,25227,345430,247,3639,0,0,86,0,0,1149,1149,0,204,3545,370657,3749,11,24
53,6/7/2020,25419,347610,205,3652,0,0,57,0,0,1153,1153,0,192,2180,373029,2372,4,13
53,6/8/2020,25732,355573,213,3669,0,0,66,0,0,1159,1159,0,313,7963,381305,8276,6,17
53,6/9/2020,26004,365086,205,3699,0,0,60,0,0,1161,1161,0,272,9513,391090,9785,2,30
53,6/10/2020,26281,376364,238,3747,0,0,92,0,0,1176,1176,0,277,11278,402645,11555,15,48
53,6/11/2020,26559,387295,226,3773,0,0,63,0,0,1190,1190,0,278,10931,413854,11209,14,26
53,6/12/2020,26825,396220,226,3772,0,0,8,0,0,1194,1194,0,266,8925,423045,9191,4,-1
53,6/13/2020,26985,402149,225,3817,0,0,43,0,0,1204,1204,0,160,5929,429134,6089,10,45
53,6/14/2020,27095,405799,229,3845,0,0,49,0,0,1213,1213,0,110,3650,432894,3760,9,28
53,6/15/2020,27493,416076,197,3856,0,0,41,0,0,1217,1217,0,398,10277,443569,10675,4,11
53,6/16/2020,27925,426586,235,3894,0,0,38,0,0,1221,1221,0,432,10510,454511,10942,4,38
53,6/17/2020,28255,435169,256,3915,0,0,47,0,0,1231,1231,0,330,8583,463424,8913,10,21
53,6/18/2020,28575,441468,263,3938,0,0,47,0,0,1226,1226,0,320,6299,470043,6619,-5,23
53,6/19/2020,28666,445796,276,3959,0,0,47,0,0,1245,1245,0,91,4328,474462,4419,19,21
53,6/20/2020,28680,446471,245,4003,0,0,49,0,0,1255,1255,0,14,675,475151,689,10,44
53,6/21/2020,28225,437844,267,4030,0,0,54,0,0,1265,1265,0,-455,-8627,466069,-9082,10,27
53,6/22/2020,28680,446258,205,4049,0,0,42,0,0,1270,1270,0,455,8414,474938,8869,5,19
53,6/23/2020,28870,448334,204,4062,0,0,37,0,0,1276,1276,0,190,2076,477204,2266,6,13
53,6/24/2020,29386,457673,234,4067,0,0,44,0,0,1284,1284,0,516,9339,487059,9855,8,5
53,6/25/2020,29869,465629,304,4093,0,0,56,0,0,1293,1293,0,483,7956,495498,8439,9,26
53,6/26/2020,30367,475428,272,4106,0,0,49,0,0,1300,1300,0,498,9799,505795,10297,7,13
53,6/27/2020,30855,483573,305,4194,0,0,50,0,0,1304,1304,0,488,8145,514428,8633,4,88
53,6/28/2020,31404,494398,304,4240,0,0,58,0,0,1310,1310,0,549,10825,525802,11374,6,46
53,6/29/2020,31752,502691,270,4275,0,0,52,0,0,1310,1310,0,348,8293,534443,8641,0,35
53,6/30/2020,32253,515967,282,4323,0,0,50,0,0,1320,1320,0,501,13276,548220,13777,10,48
53,7/1/2020,32824,524451,288,4361,0,0,50,0,0,1332,1332,0,571,8484,557275,9055,12,38
53,7/2/2020,33435,538529,311,4402,0,0,57,0,0,1339,1339,0,611,14078,571964,14689,7,41
53,7/3/2020,34151,550838,334,4442,0,0,62,0,0,1342,1342,0,716,12309,584989,13025,3,40
53,7/4/2020,34778,565197,315,4463,0,0,58,0,0,1352,1352,0,627,14359,599975,14986,10,21
53,7/5/2020,35247,572029,305,4473,0,0,56,0,0,1354,1354,0,469,6832,607276,7301,2,10
53,7/6/2020,35898,576808,248,4482,0,0,39,0,0,1359,1359,0,651,4779,612706,5430,5,9
53,7/7/2020,36985,592271,222,4544,0,0,37,0,0,1370,1370,0,1087,15463,629256,16550,11,62
53,7/8/2020,37420,598104,318,4582,0,0,52,0,0,1384,1384,0,435,5833,635524,6268,14,38
53,7/9/2020,37941,607131,329,4630,0,0,59,0,0,1394,1394,0,521,9027,645072,9548,10,48
53,7/10/2020,38581,621749,326,4665,0,0,60,0,0,1409,1409,0,640,14618,660330,15258,15,35
53,7/11/2020,39218,629248,326,4662,0,0,57,0,0,1424,1424,0,637,7499,668466,8136,15,-3
53,7/12/2020,39218,629248,326,4662,0,0,57,0,0,1424,1424,0,0,0,668466,0,0,0
53,7/13/2020,40656,645349,331,4751,0,0,35,0,0,1438,1438,0,1438,16101,686005,17539,14,89
53,7/14/2020,41757,666517,332,4778,0,0,39,0,0,1399,1399,0,1101,21168,708274,22269,-39,27
53,7/15/2020,42304,675930,353,4788,0,0,55,0,0,1404,1404,0,547,9413,718234,9960,5,10
53,7/16/2020,43046,690840,372,4829,0,0,53,0,0,1421,1421,0,742,14910,733886,15652,17,41
53,7/17/2020,44313,708861,379,4944,0,0,45,0,0,1427,1427,0,1267,18021,753174,19288,6,115
54,3/6/2020,0,1,0,0,0,0,0,0,0,0,0,0,0,0,1,0,0,0
54,3/7/2020,0,2,0,0,0,0,0,0,0,0,0,0,0,1,2,1,0,0
54,3/8/2020,0,2,0,0,0,0,0,0,0,0,0,0,0,0,2,0,0,0
54,3/9/2020,0,2,0,0,0,0,0,0,0,0,0,0,0,0,2,0,0,0
54,3/10/2020,0,2,0,0,0,0,0,0,0,0,0,0,0,0,2,0,0,0
54,3/11/2020,0,3,0,0,0,0,0,0,0,0,0,0,0,1,3,1,0,0
54,3/12/2020,0,7,0,0,0,0,0,0,0,0,0,0,0,4,7,4,0,0
54,3/13/2020,0,17,0,0,0,0,0,0,0,0,0,0,0,10,17,10,0,0
54,3/14/2020,0,26,0,0,0,0,0,0,0,0,0,0,0,9,26,9,0,0
54,3/15/2020,0,38,0,0,0,0,0,0,0,0,0,0,0,12,38,12,0,0
54,3/16/2020,0,80,0,0,0,0,0,0,0,0,0,0,0,42,80,42,0,0
54,3/17/2020,0,80,0,0,0,0,0,0,0,0,0,0,0,0,80,0,0,0
54,3/18/2020,1,122,0,0,0,0,0,0,0,0,0,0,1,42,123,43,0,0
54,3/19/2020,2,143,0,0,0,0,0,0,0,0,0,0,1,21,145,22,0,0
54,3/20/2020,7,219,0,0,0,0,0,0,0,0,0,0,5,76,226,81,0,0
54,3/21/2020,11,330,0,1,0,0,0,0,0,0,0,0,4,111,341,115,0,1
54,3/22/2020,12,385,0,1,0,0,0,0,0,0,0,0,1,55,397,56,0,0
54,3/23/2020,16,444,0,1,0,0,0,0,0,0,0,0,4,59,460,63,0,0
54,3/24/2020,20,610,0,1,0,0,0,0,0,0,0,0,4,166,630,170,0,0
54,3/25/2020,39,759,0,1,0,0,0,0,0,0,0,0,19,149,798,168,0,0
54,3/26/2020,51,1031,0,1,0,0,0,0,0,0,0,0,12,272,1082,284,0,0
54,3/27/2020,76,1779,0,1,0,0,0,0,0,0,0,0,25,748,1855,773,0,0
54,3/28/2020,96,2331,0,1,0,0,0,0,0,0,0,0,20,552,2427,572,0,0
54,3/29/2020,113,2705,0,1,0,0,0,0,0,0,0,0,17,374,2818,391,0,0
54,3/30/2020,126,2984,0,1,0,0,0,0,0,1,0,0,13,279,3110,292,1,0
54,3/31/2020,162,3981,0,1,0,0,0,0,0,1,0,0,36,997,4143,1033,0,0
54,4/1/2020,191,4384,0,1,0,0,0,0,0,1,0,0,29,403,4575,432,0,0
54,4/2/2020,217,5276,0,1,0,0,0,0,0,2,0,0,26,892,5493,918,1,0
54,4/3/2020,237,6130,0,1,0,0,0,0,0,2,0,0,20,854,6367,874,0,0
54,4/4/2020,282,7404,0,0,0,0,0,0,0,2,0,0,45,1274,7686,1319,0,-1
54,4/5/2020,324,8514,0,0,0,0,0,0,0,3,0,0,42,1110,8838,1152,1,0
54,4/6/2020,345,9595,0,0,0,0,0,0,0,4,0,0,21,1081,9940,1102,1,0
54,4/7/2020,412,11647,0,0,0,0,0,0,0,4,0,0,67,2052,12059,2119,0,0
54,4/8/2020,462,12083,0,0,0,0,0,0,0,4,0,0,50,436,12545,486,0,0
54,4/9/2020,523,13340,0,0,0,0,0,0,0,5,0,0,61,1257,13863,1318,1,0
54,4/10/2020,554,14001,85,0,20,0,22,0,63,5,0,0,31,661,14555,692,0,0
54,4/11/2020,577,14875,85,0,40,0,22,0,63,5,0,0,23,874,15452,897,0,0
54,4/12/2020,611,15646,81,0,36,0,24,0,83,8,0,0,34,771,16257,805,3,0
54,4/13/2020,626,16029,95,164,43,73,23,50,85,9,0,0,15,383,16655,398,1,164
54,4/14/2020,640,16398,87,164,38,73,25,50,147,9,0,0,14,369,17038,383,0,0
54,4/15/2020,702,16954,82,164,36,73,23,50,211,10,0,0,62,556,17656,618,1,0
54,4/16/2020,739,17567,85,0,34,0,24,0,223,13,0,0,37,613,18306,650,3,-164
54,4/17/2020,754,17927,85,0,34,0,24,0,223,13,0,0,15,360,18681,375,0,0
54,4/18/2020,785,18655,83,0,40,0,27,0,255,16,0,0,31,728,19440,759,3,0
54,4/19/2020,863,19168,72,0,37,0,25,0,265,18,0,0,78,513,20031,591,2,0
54,4/20/2020,902,21253,77,0,37,0,23,0,290,24,0,0,39,2085,22155,2124,6,0
54,4/21/2020,914,21849,85,0,42,0,24,0,330,26,0,0,12,596,22763,608,2,0
54,4/22/2020,939,24897,103,0,41,0,23,0,330,26,0,0,25,3048,25836,3073,0,0
54,4/23/2020,967,26938,108,0,44,0,24,0,380,29,0,0,28,2041,27905,2069,3,0
54,4/24/2020,988,28823,97,0,36,0,19,0,439,32,0,0,21,1885,29811,1906,3,0
54,4/25/2020,1020,31946,97,0,36,0,19,0,439,32,0,0,32,3123,32966,3155,0,0
54,4/26/2020,1044,38019,100,0,38,0,20,0,455,34,0,0,24,6073,39063,6097,2,0
54,4/27/2020,1063,41976,100,0,38,0,20,0,455,36,0,0,19,3957,43039,3976,2,0
54,4/28/2020,1079,41976,87,0,28,0,15,0,481,37,0,0,16,0,43055,16,1,0
54,4/29/2020,1095,41976,102,0,40,0,21,0,504,38,0,0,16,0,43071,16,1,0
54,4/30/2020,1118,43423,84,0,38,0,20,0,545,41,0,0,23,1447,44541,1470,3,0
54,5/1/2020,1136,45708,81,0,33,0,18,0,555,46,0,0,18,2285,46844,2303,5,0
54,5/2/2020,1169,47977,76,0,29,0,15,0,572,48,0,0,33,2269,49146,2302,2,0
54,5/3/2020,1191,50447,73,0,28,0,15,0,611,50,0,0,22,2470,51638,2492,2,0
54,5/4/2020,1206,52033,73,0,28,0,15,0,611,50,0,0,15,1586,53239,1601,0,0
54,5/5/2020,1238,53585,64,0,23,0,12,0,630,50,0,0,32,1552,54823,1584,0,0
54,5/6/2020,1248,54536,76,0,22,0,12,0,716,50,0,0,10,951,55784,961,0,0
54,5/7/2020,1287,56234,76,0,22,0,12,0,716,51,0,0,39,1698,57521,1737,1,0
54,5/8/2020,1310,58126,65,0,19,0,11,0,761,51,0,0,23,1892,59436,1915,0,0
54,5/9/2020,1335,59662,53,0,13,0,7,0,761,53,0,0,25,1536,60997,1561,2,0
54,5/10/2020,1360,61284,49,0,10,0,6,0,775,54,0,0,25,1622,62644,1647,1,0
54,5/11/2020,1366,62103,49,0,10,0,6,0,775,54,0,0,6,819,63469,825,0,0
54,5/12/2020,1371,63698,50,0,9,0,5,0,803,57,0,0,5,1595,65069,1600,3,0
54,5/13/2020,1398,65282,58,0,11,0,6,0,813,58,0,0,27,1584,66680,1611,1,0
54,5/14/2020,1427,67286,52,0,9,0,5,0,870,60,0,0,29,2004,68713,2033,2,0
54,5/15/2020,1441,69495,57,0,15,0,8,0,870,62,0,0,14,2209,70936,2223,2,0
54,5/16/2020,1457,71936,55,0,13,0,6,0,889,64,0,0,16,2441,73393,2457,2,0
54,5/17/2020,1490,74000,48,0,11,0,7,0,919,67,0,0,33,2064,75490,2097,3,0
54,5/18/2020,1491,74544,48,0,11,0,7,0,919,67,0,0,1,544,76035,545,0,0
54,5/19/2020,1509,76792,54,0,18,0,9,0,922,68,0,0,18,2248,78301,2266,1,0
54,5/20/2020,1545,79096,58,0,16,0,9,0,950,69,0,0,36,2304,80641,2340,1,0
54,5/21/2020,1593,81548,46,0,12,0,9,0,983,70,0,0,48,2452,83141,2500,1,0
54,5/22/2020,1616,83213,47,0,13,0,9,0,983,71,0,0,23,1665,84829,1688,1,0
54,5/23/2020,1717,82027,39,0,11,0,9,0,1110,72,0,0,101,-1186,83744,-1085,1,0
54,5/24/2020,1759,83935,23,0,8,0,4,0,1121,72,0,0,42,1908,85694,1950,0,0
54,5/25/2020,1774,84551,36,0,13,0,7,0,1135,72,0,0,15,616,86325,631,0,0
54,5/26/2020,1854,85957,35,0,9,0,7,0,1180,74,0,0,80,1406,87811,1486,2,0
54,5/27/2020,1867,86594,36,0,13,0,6,0,1191,74,0,0,13,637,88461,650,0,0
54,5/28/2020,1906,88409,35,0,13,0,6,0,1211,74,0,0,39,1815,90315,1854,0,0
54,5/29/2020,1951,91426,33,0,14,0,8,0,1241,74,0,0,45,3017,93377,3062,0,0
54,5/30/2020,1974,93916,33,0,14,0,8,0,1290,75,0,0,23,2490,95890,2513,1,0
54,5/31/2020,2010,95612,33,0,14,0,8,0,1303,75,0,0,36,1696,97622,1732,0,0
54,6/1/2020,2017,96078,31,0,11,0,4,0,1313,75,0,0,7,466,98095,473,0,0
54,6/2/2020,2041,98502,31,0,11,0,4,0,1341,77,0,0,24,2424,100543,2448,2,0
54,6/3/2020,2071,101697,34,0,13,0,4,0,1381,78,0,0,30,3195,103768,3225,1,0
54,6/4/2020,2092,103957,28,0,11,0,2,0,1399,78,0,0,21,2260,106049,2281,0,0
54,6/5/2020,2119,106399,27,0,11,0,3,0,1445,84,0,0,27,2442,108518,2469,6,0
54,6/6/2020,2131,107592,27,0,11,0,3,0,1446,84,0,0,12,1193,109723,1205,0,0
54,6/7/2020,2144,109663,28,0,9,0,4,0,1451,84,0,0,13,2071,111807,2084,0,0
54,6/8/2020,2153,111452,24,0,9,0,4,0,1468,84,0,0,9,1789,113605,1798,0,0
54,6/9/2020,2169,112169,24,0,9,0,4,0,1477,84,0,0,16,717,114338,733,0,0
54,6/10/2020,2188,115802,24,0,9,0,5,0,1485,85,0,0,19,3633,117990,3652,1,0
54,6/11/2020,2212,118908,38,0,8,0,2,0,1516,85,0,0,24,3106,121120,3130,0,0
54,6/12/2020,2233,121806,29,0,9,0,2,0,1553,86,0,0,21,2898,124039,2919,1,0
54,6/13/2020,2259,125258,29,0,9,0,2,0,1568,88,0,0,26,3452,127517,3478,2,0
54,6/14/2020,2289,128910,30,0,8,0,2,0,1571,88,0,0,30,3652,131199,3682,0,0
54,6/15/2020,2298,129655,25,0,8,0,2,0,1585,88,0,0,9,745,131953,754,0,0
54,6/16/2020,2341,134730,24,0,8,0,3,0,1636,88,0,0,43,5075,137071,5118,0,0
54,6/17/2020,2376,138994,23,0,7,0,2,0,1654,88,0,0,35,4264,141370,4299,0,0
54,6/18/2020,2418,142011,25,0,5,0,2,0,1665,88,0,0,42,3017,144429,3059,0,0
54,6/19/2020,2435,143579,22,0,6,0,2,0,1665,88,0,0,17,1568,146014,1585,0,0
54,6/20/2020,2486,145910,22,0,6,0,2,0,1669,88,0,0,51,2331,148396,2382,0,0
54,6/21/2020,2543,148046,23,0,3,0,2,0,1676,89,0,0,57,2136,150589,2193,1,0
54,6/22/2020,2552,148652,21,0,5,0,2,0,1681,89,0,0,9,606,151204,615,0,0
54,6/23/2020,2582,151746,21,0,5,0,2,0,1790,92,0,0,30,3094,154328,3124,3,0
54,6/24/2020,2629,154419,24,0,5,0,2,0,1855,92,0,0,47,2673,157048,2720,0,0
54,6/25/2020,2661,156043,24,0,5,0,2,0,1858,92,0,0,32,1624,158704,1656,0,0
54,6/26/2020,2712,159245,33,0,10,0,4,0,1907,92,0,0,51,3202,161957,3253,0,0
54,6/27/2020,2761,161894,33,0,10,0,4,0,2042,93,0,0,49,2649,164655,2698,1,0
54,6/28/2020,2817,163691,32,0,10,0,4,0,2062,93,0,0,56,1797,166508,1853,0,0
54,6/29/2020,2870,166785,28,0,5,0,3,0,2196,93,0,0,53,3094,169655,3147,0,0
54,6/30/2020,2905,168859,27,0,10,0,3,0,2272,93,0,0,35,2074,171764,2109,0,0
54,7/1/2020,2932,170420,23,0,5,0,3,0,2284,93,0,0,27,1561,173352,1588,0,0
54,7/2/2020,3053,175288,23,0,10,0,5,0,2380,93,0,0,121,4868,178341,4989,0,0
54,7/3/2020,3126,177576,25,0,11,0,4,0,2396,93,0,0,73,2288,180702,2361,0,0
54,7/4/2020,3141,178288,25,0,11,0,4,0,2402,94,0,0,15,712,181429,727,1,0
54,7/5/2020,3262,181559,27,0,12,0,5,0,2421,94,0,0,121,3271,184821,3392,0,0
54,7/6/2020,3442,185539,41,0,13,0,6,0,2518,95,0,0,180,3980,188981,4160,1,0
54,7/7/2020,3461,186386,41,0,13,0,6,0,2535,95,0,0,19,847,189847,866,0,0
54,7/8/2020,3707,190208,48,0,13,0,7,0,2648,95,0,0,246,3822,193915,4068,0,0
54,7/9/2020,3826,193363,50,0,15,0,6,0,2718,95,0,0,119,3155,197189,3274,0,0
54,7/10/2020,3983,197220,56,0,16,0,7,0,2756,95,0,0,157,3857,201203,4014,0,0
54,7/11/2020,4074,199749,56,0,14,0,7,0,2763,95,0,0,91,2529,203823,2620,0,0
54,7/12/2020,4207,202829,56,0,14,0,7,0,2806,96,0,0,133,3080,207036,3213,1,0
54,7/13/2020,4259,203966,63,0,22,0,8,0,2825,96,0,0,52,1137,208225,1189,0,0
54,7/14/2020,4407,209605,59,0,24,0,7,0,2982,97,0,0,148,5639,214012,5787,1,0
54,7/15/2020,4557,213347,63,0,26,0,13,0,2999,97,0,0,150,3742,217904,3892,0,0
54,7/16/2020,4657,214517,65,0,29,0,13,0,3128,99,0,0,100,1170,219174,1270,2,0
54,7/17/2020,4783,217769,69,0,37,0,15,0,3627,100,0,0,126,3252,222552,3378,1,0
55,3/4/2020,1,19,0,0,0,0,0,0,0,0,0,0,0,0,20,0,0,0
55,3/5/2020,1,19,0,0,0,0,0,0,0,0,0,0,0,0,20,0,0,0
55,3/6/2020,1,31,0,0,0,0,0,0,0,0,0,0,0,12,32,12,0,0
55,3/7/2020,1,31,0,0,0,0,0,0,0,0,0,0,0,0,32,0,0,0
55,3/8/2020,1,31,0,0,0,0,0,0,0,0,0,0,0,0,32,0,0,0
55,3/9/2020,1,36,0,0,0,0,0,0,0,0,0,0,0,5,37,5,0,0
55,3/10/2020,2,36,0,0,0,0,0,0,0,0,0,0,1,0,38,1,0,0
55,3/11/2020,3,43,0,0,0,0,0,0,0,0,0,0,1,7,46,8,0,0
55,3/12/2020,9,84,0,0,0,0,0,0,0,0,0,0,6,41,93,47,0,0
55,3/13/2020,23,169,0,0,0,0,0,0,0,0,0,0,14,85,192,99,0,0
55,3/14/2020,23,169,0,0,0,0,0,0,0,0,0,0,0,0,192,0,0,0
55,3/15/2020,37,313,0,0,0,0,0,0,0,0,0,0,14,144,350,158,0,0
55,3/16/2020,56,504,0,0,0,0,0,0,0,0,0,0,19,191,560,210,0,0
55,3/17/2020,83,1038,0,0,0,0,0,0,0,0,0,0,27,534,1121,561,0,0
55,3/18/2020,121,1577,0,0,0,0,0,0,0,0,0,0,38,539,1698,577,0,0
55,3/19/2020,174,2192,0,0,0,0,0,0,0,0,0,0,53,615,2366,668,0,0
55,3/20/2020,235,3455,0,0,0,0,0,0,0,3,0,0,61,1263,3690,1324,3,0
55,3/21/2020,315,4628,0,0,0,0,0,0,0,4,0,0,80,1173,4943,1253,1,0
55,3/22/2020,425,6230,0,0,0,0,0,0,0,4,0,0,110,1602,6655,1712,0,0
55,3/23/2020,466,7050,0,0,0,0,0,0,0,5,0,0,41,820,7516,861,1,0
55,3/24/2020,525,8237,0,0,0,0,0,0,0,5,0,0,59,1187,8762,1246,0,0
55,3/25/2020,667,10089,0,0,0,0,0,0,0,7,0,0,142,1852,10756,1994,2,0
55,3/26/2020,806,11583,0,0,0,0,0,0,0,8,0,0,139,1494,12389,1633,1,0
55,3/27/2020,969,13140,0,0,0,0,0,0,0,13,0,0,163,1557,14109,1720,5,0
55,3/28/2020,1134,15232,0,0,0,0,0,0,0,13,0,0,165,2092,16366,2257,0,0
55,3/29/2020,1276,16550,0,0,0,0,0,0,0,13,0,0,142,1318,17826,1460,0,0
55,3/30/2020,1422,15856,0,0,0,0,0,0,0,14,0,0,146,-694,17278,-548,1,0
55,3/31/2020,1585,17375,0,337,0,0,0,0,0,16,0,0,163,1519,18960,1682,2,337
55,4/1/2020,1821,18819,0,398,0,0,0,0,0,24,0,0,236,1444,20640,1680,8,61
55,4/2/2020,2040,20317,0,461,0,0,0,0,0,31,0,0,219,1498,22357,1717,7,63
55,4/3/2020,2263,22377,0,487,0,0,0,0,0,37,0,0,223,2060,24640,2283,6,26
55,4/4/2020,2476,23859,0,588,0,0,0,0,0,56,0,0,213,1482,26335,1695,19,101
55,4/5/2020,2643,25169,0,624,0,175,0,0,0,68,0,0,167,1310,27812,1477,12,36
55,4/6/2020,2866,26574,0,668,0,186,0,0,0,77,0,0,223,1405,29440,1628,9,44
55,4/7/2020,3064,28512,0,745,0,200,0,0,0,92,0,0,198,1938,31576,2136,15,77
55,4/8/2020,3279,30115,0,790,0,218,0,0,0,99,0,0,215,1603,33394,1818,7,45
55,4/9/2020,3443,31424,0,843,0,230,0,0,0,111,0,0,164,1309,34867,1473,12,53
55,4/10/2020,3665,33225,0,904,190,247,0,0,0,128,0,0,222,1801,36890,2023,17,61
55,4/11/2020,3822,34680,444,950,179,257,0,0,0,137,0,0,157,1455,38502,1612,9,46
55,4/12/2020,3964,35916,442,974,179,261,0,0,0,144,0,0,142,1236,39880,1378,7,24
55,4/13/2020,4080,36769,442,993,175,264,0,0,0,154,0,0,116,853,40849,969,10,19
55,4/14/2020,4246,37997,432,1049,161,283,0,0,0,170,0,0,166,1228,42243,1394,16,56
55,4/15/2020,4453,39326,406,1091,163,290,0,0,0,182,0,0,207,1329,43779,1536,12,42
55,4/16/2020,4636,40974,394,1121,147,299,0,0,0,197,0,0,183,1648,45610,1831,15,30
55,4/17/2020,4839,42365,361,1153,141,306,348,0,0,205,0,0,203,1391,47204,1594,8,32
55,4/18/2020,5013,43962,361,1176,135,307,0,0,0,211,0,0,174,1597,48975,1771,6,23
55,4/19/2020,5176,45323,397,1190,162,307,0,0,0,220,0,0,163,1361,50499,1524,9,14
55,4/20/2020,5353,46603,406,1211,168,307,0,0,0,230,0,0,177,1280,51956,1457,10,21
55,4/21/2020,5509,47841,358,1252,137,324,0,0,0,242,0,0,156,1238,53350,1394,12,41
55,4/22/2020,5766,49502,355,1302,139,324,0,0,0,246,0,0,257,1661,55268,1918,4,50
55,4/23/2020,6011,51456,349,1318,146,342,0,0,0,257,0,0,245,1954,57467,2199,11,16
55,4/24/2020,6364,54573,361,1353,143,346,0,0,0,262,0,0,353,3117,60937,3470,5,35
55,4/25/2020,6715,57138,337,1376,136,353,0,0,0,266,0,0,351,2565,63853,2916,4,23
55,4/26/2020,6963,59235,337,1397,136,353,0,0,0,272,0,0,248,2097,66198,2345,6,21
55,4/27/2020,7161,61311,337,1415,124,355,0,0,0,281,0,0,198,2076,68472,2274,9,18
55,4/28/2020,7391,63535,544,1456,123,363,0,0,0,300,0,0,230,2224,70926,2454,19,41
55,4/29/2020,7660,66630,577,1489,121,363,0,0,0,308,0,0,269,3095,74290,3364,8,33
55,4/30/2020,8052,69394,554,1512,119,382,0,0,3352,316,0,0,392,2764,77446,3156,8,23
55,5/1/2020,8550,72566,560,1544,127,391,0,0,3352,327,0,0,498,3172,81116,3670,11,32
55,5/2/2020,8920,75570,582,1591,118,400,0,0,3698,334,0,0,370,3004,84490,3374,7,47
55,5/3/2020,9227,77997,582,1608,118,402,0,0,3723,339,0,0,307,2427,87224,2734,5,17
55,5/4/2020,9538,80467,573,1621,116,404,0,0,3973,340,0,0,311,2470,90005,2781,1,13
55,5/5/2020,9896,83967,543,1663,92,414,0,0,4131,353,0,0,358,3500,93863,3858,13,42
55,5/6/2020,10262,87826,511,1694,107,423,0,0,4348,362,0,0,366,3859,98088,4225,9,31
55,5/7/2020,10621,93035,624,1732,108,435,0,0,4520,374,0,0,359,5209,103656,5568,12,38
55,5/8/2020,11030,97265,552,1767,110,441,0,0,4694,384,0,0,409,4230,108295,4639,10,35
55,5/9/2020,11402,101935,543,1806,110,452,0,0,4875,398,0,0,372,4670,113337,5042,14,39
55,5/10/2020,11694,105163,514,1820,113,456,0,0,5014,400,0,0,292,3228,116857,3520,2,14
55,5/11/2020,11920,108033,520,1846,116,460,0,0,5176,409,0,0,226,2870,119953,3096,9,26
55,5/12/2020,12131,112748,520,1877,116,464,0,0,5371,418,418,0,211,4715,124879,4926,9,31
55,5/13/2020,12449,117111,527,1908,110,469,0,0,5673,421,421,0,318,4363,129560,4681,3,31
55,5/14/2020,12869,122598,507,1939,121,478,0,0,5994,434,434,0,420,5487,135467,5907,13,31
55,5/15/2020,13344,128657,548,1977,113,485,0,0,6250,445,445,0,475,6059,142001,6534,11,38
55,5/16/2020,13878,134206,546,2018,127,488,0,0,6542,453,453,0,534,5549,148084,6083,8,41
55,5/17/2020,14257,139674,543,2038,129,494,0,0,6542,453,453,0,379,5468,153931,5847,0,20
55,5/18/2020,14442,144502,574,2068,128,496,0,0,6786,459,459,0,185,4828,158944,5013,6,30
55,5/19/2020,14692,148237,609,2110,129,503,0,0,7371,467,467,0,250,3735,162929,3985,8,42
55,5/20/2020,15269,154300,609,2161,129,515,0,0,7728,481,481,0,577,6063,169569,6640,14,51
55,5/21/2020,15792,163238,524,2218,126,526,0,0,8012,487,487,0,523,8938,179030,9461,6,57
55,5/22/2020,16340,172703,583,2259,133,535,0,0,8362,496,496,0,548,9465,189043,10013,9,41
55,5/23/2020,16843,179329,611,2292,128,542,0,0,8688,507,507,0,503,6626,196172,7129,11,33
55,5/24/2020,17253,186206,611,2315,128,541,0,0,8999,510,510,0,410,6877,203459,7287,3,23
55,5/25/2020,17571,193379,606,2339,126,543,0,0,9207,514,514,0,318,7173,210950,7491,4,24
55,5/26/2020,17867,200874,640,2362,135,544,0,0,9405,517,517,0,296,7495,218741,7791,3,23
55,5/27/2020,18513,210605,748,2411,139,550,0,0,9846,539,539,0,646,9731,229118,10377,22,49
55,5/28/2020,19077,220719,659,2452,138,556,0,0,10384,550,550,0,564,10114,239796,10678,11,41
55,5/29/2020,19843,233588,658,2499,145,567,0,0,10880,568,568,0,766,12869,253431,13635,18,47
55,5/30/2020,20382,242908,617,2563,144,577,0,0,11338,588,588,0,539,9320,263290,9859,20,64
55,5/31/2020,20564,250103,625,2583,133,585,0,0,11646,592,592,0,182,7195,270667,7377,4,20
55,6/1/2020,20736,253595,613,2603,136,586,0,0,11838,595,595,0,172,3492,274331,3664,3,20
55,6/2/2020,21155,263743,597,2643,139,593,0,0,12172,607,607,0,419,10148,284898,10567,12,40
55,6/3/2020,21661,279711,556,2700,130,606,0,0,12172,616,616,0,506,15968,301372,16474,9,57
55,6/4/2020,22193,291367,551,2739,117,616,0,0,12980,626,626,0,532,11656,313560,12188,10,39
55,6/5/2020,22599,303332,526,2791,124,625,0,0,13337,633,633,0,406,11965,325931,12371,7,52
55,6/6/2020,22937,314802,492,2832,118,636,0,0,13770,645,645,0,338,11470,337739,11808,12,41
55,6/7/2020,23212,325867,491,2848,107,638,0,0,14047,647,647,0,275,11065,349079,11340,2,16
55,6/8/2020,23434,333253,528,2860,110,637,0,0,14242,646,646,0,222,7386,356687,7608,-1,12
55,6/9/2020,23734,347210,505,2904,117,649,0,0,14583,661,661,0,300,13957,370944,14257,15,44
55,6/10/2020,24070,357112,328,2943,114,654,0,0,14999,671,671,0,336,9902,381182,10238,10,39
55,6/11/2020,24441,366054,306,2976,101,660,0,0,15348,682,682,0,371,8942,390495,9313,11,33
55,6/12/2020,24795,377362,287,3003,104,670,0,0,15783,689,689,0,354,11308,402157,11662,7,27
55,6/13/2020,25089,388399,285,3035,99,677,0,0,16231,691,691,0,294,11037,413488,11331,2,32
55,6/14/2020,25340,397366,289,3049,101,680,0,0,16558,692,692,0,251,8967,422706,9218,1,14
55,6/15/2020,25546,403447,284,3061,100,680,0,0,16837,694,694,0,206,6081,428993,6287,2,12
55,6/16/2020,25844,414330,275,3096,100,687,0,0,17122,703,703,0,298,10883,440174,11181,9,35
55,6/17/2020,26129,423736,244,3128,94,696,0,0,17613,712,712,0,285,9406,449865,9691,9,32
55,6/18/2020,26590,433913,240,3160,83,701,0,0,18055,719,719,0,461,10177,460503,10638,7,32
55,6/19/2020,26913,444751,240,3177,91,704,0,0,18055,730,730,0,323,10838,471664,11161,11,17
55,6/20/2020,27326,454563,239,3203,90,708,0,0,18951,744,744,0,413,9812,481889,10225,14,26
55,6/21/2020,27615,460334,242,3220,94,710,0,0,19310,744,744,0,289,5771,487949,6060,0,17
55,6/22/2020,27878,466634,246,3231,93,711,0,0,19543,745,745,0,263,6300,494512,6563,1,11
55,6/23/2020,28175,478165,240,3268,93,716,0,0,19852,750,750,0,297,11531,506340,11828,5,37
55,6/24/2020,28641,487803,239,3299,89,723,0,0,20121,757,757,0,466,9638,516444,10104,7,31
55,6/25/2020,29105,498561,249,3326,93,734,0,0,20557,766,766,0,464,10758,527666,11222,9,27
55,6/26/2020,29668,507168,262,3351,95,741,0,0,21174,766,766,0,563,8607,536836,9170,0,25
55,6/27/2020,30227,515723,249,3382,93,746,0,0,21606,777,777,0,559,8555,545950,9114,11,31
55,6/28/2020,30707,521747,239,3393,89,746,0,0,21953,777,777,0,480,6024,552454,6504,0,11
55,6/29/2020,31033,527359,237,3407,90,747,0,0,22217,784,777,7,326,5612,558392,5938,7,14
55,6/30/2020,31662,539539,242,3446,79,750,0,0,22587,784,777,7,629,12180,571201,12809,0,39
55,7/1/2020,32225,551607,237,3482,77,757,0,0,23089,793,786,7,563,12068,583832,12631,9,36
55,7/2/2020,32809,563946,236,3519,74,763,0,0,23527,800,793,7,584,12339,596755,12923,7,37
55,7/3/2020,33431,573553,244,3555,75,768,0,0,24043,803,796,7,622,9607,606984,10229,3,36
55,7/4/2020,34207,579637,235,3574,67,771,0,0,24491,803,796,7,776,6084,613844,6860,0,19
55,7/5/2020,34740,584111,244,3586,65,771,0,0,24899,803,796,7,533,4474,618851,5007,0,12
55,7/6/2020,35230,588913,254,3602,66,772,0,0,25242,803,796,7,490,4802,624143,5292,0,16
55,7/7/2020,35765,601012,254,3639,69,777,0,0,25758,812,805,7,535,12099,636777,12634,9,37
55,7/8/2020,36410,611150,276,3683,74,787,0,0,26305,814,807,7,645,10138,647560,10783,2,44
55,7/9/2020,37210,623554,285,3726,76,787,0,0,26792,816,809,7,800,12404,660764,13204,2,43
55,7/10/2020,38099,635411,274,3766,77,792,0,0,27329,821,814,7,889,11857,673510,12746,5,40
55,7/11/2020,39080,646504,265,3797,75,797,0,0,27909,828,821,7,981,11093,685584,12074,7,31
55,7/12/2020,39877,653352,264,3824,74,800,0,0,28318,827,820,7,797,6848,693229,7645,-1,27
55,7/13/2020,40382,659479,283,3850,85,800,0,0,28670,827,820,7,505,6127,699861,6632,0,26
55,7/14/2020,41349,673195,293,3892,83,804,0,0,29275,833,826,7,967,13716,714544,14683,6,42
55,7/15/2020,42197,686299,295,3923,88,810,0,0,29923,834,827,7,848,13104,728496,13952,1,31
55,7/16/2020,43139,699670,310,3968,88,811,0,0,30555,838,831,7,942,13371,742809,14313,4,45
55,7/17/2020,44068,712197,333,4031,97,816,0,0,31258,840,833,7,929,12527,756265,13456,2,63
56,3/7/2020,0,0,0,0,0,0,0,0,0,0,0,0,0,0,0,0,0,0
56,3/8/2020,0,0,0,0,0,0,0,0,0,0,0,0,0,0,0,0,0,0
56,3/9/2020,0,0,0,0,0,0,0,0,0,0,0,0,0,0,0,0,0,0
56,3/10/2020,0,0,0,0,0,0,0,0,0,0,0,0,0,0,0,0,0,0
56,3/11/2020,0,0,0,0,0,0,0,0,0,0,0,0,0,0,0,0,0,0
56,3/12/2020,1,0,0,0,0,0,0,0,0,0,0,0,1,0,1,1,0,0
56,3/13/2020,1,0,0,0,0,0,0,0,0,0,0,0,0,0,1,0,0,0
56,3/14/2020,2,0,0,0,0,0,0,0,0,0,0,0,1,0,2,1,0,0
56,3/15/2020,3,0,0,0,0,0,0,0,0,0,0,0,1,0,3,1,0,0
56,3/16/2020,3,0,0,0,0,0,0,0,0,0,0,0,0,0,3,0,0,0
56,3/17/2020,10,95,0,0,0,0,0,0,0,0,0,0,7,95,105,102,0,0
56,3/18/2020,15,178,0,0,0,0,0,0,0,0,0,0,5,83,193,88,0,0
56,3/19/2020,18,271,0,0,0,0,0,0,0,0,0,0,3,93,289,96,0,0
56,3/20/2020,19,331,0,0,0,0,0,0,0,0,0,0,1,60,350,61,0,0
56,3/21/2020,23,438,0,0,0,0,0,0,0,0,0,0,4,107,461,111,0,0
56,3/22/2020,24,438,0,0,0,0,0,0,0,0,0,0,1,0,462,1,0,0
56,3/23/2020,26,592,0,0,0,0,0,0,0,0,0,0,2,154,618,156,0,0
56,3/24/2020,29,710,0,0,0,0,0,0,0,0,0,0,3,118,739,121,0,0
56,3/25/2020,44,954,0,0,0,0,0,0,7,0,0,0,15,244,998,259,0,0
56,3/26/2020,53,1052,0,0,0,0,0,0,12,0,0,0,9,98,1105,107,0,0
56,3/27/2020,70,1211,0,11,0,0,0,0,17,0,0,0,17,159,1281,176,0,11
56,3/28/2020,82,1475,0,14,0,0,0,0,18,0,0,0,12,264,1557,276,0,3
56,3/29/2020,86,1554,0,15,0,0,0,0,20,0,0,0,4,79,1640,83,0,1
56,3/30/2020,94,1840,0,17,0,0,0,0,24,0,0,0,8,286,1934,294,0,2
56,3/31/2020,109,1999,0,17,0,0,0,0,26,0,0,0,15,159,2108,174,0,0
56,4/1/2020,130,2218,0,18,0,0,0,0,31,0,0,0,21,219,2348,240,0,1
56,4/2/2020,150,2439,0,19,0,0,0,0,31,0,0,0,20,221,2589,241,0,1
56,4/3/2020,162,2704,0,21,0,0,0,0,37,0,0,0,12,265,2866,277,0,2
56,4/4/2020,187,2945,0,23,0,0,0,0,49,0,0,0,25,241,3132,266,0,2
56,4/5/2020,197,3040,0,23,0,0,0,0,50,0,0,0,10,95,3237,105,0,0
56,4/6/2020,210,3719,0,23,0,0,0,0,52,0,0,0,13,679,3929,692,0,0
56,4/7/2020,216,3789,0,33,0,0,0,0,62,0,0,0,6,70,4005,76,0,10
56,4/8/2020,221,3843,0,33,0,0,0,0,62,0,0,0,5,54,4064,59,0,0
56,4/9/2020,230,3920,0,34,0,0,0,0,94,0,0,0,9,77,4150,86,0,1
56,4/10/2020,253,4736,0,37,0,0,0,0,105,0,0,0,23,816,4989,839,0,3
56,4/11/2020,261,5198,0,37,0,0,0,0,129,0,0,0,8,462,5459,470,0,0
56,4/12/2020,261,5198,0,40,0,0,0,0,137,0,0,0,0,0,5459,0,0,3
56,4/13/2020,275,5689,0,41,0,0,0,0,138,1,0,0,14,491,5964,505,1,1
56,4/14/2020,275,5689,0,43,0,0,0,0,140,1,0,0,0,0,5964,0,0,2
56,4/15/2020,287,6042,0,43,0,0,0,0,129,2,0,0,12,353,6329,365,1,0
56,4/16/2020,296,6131,19,43,0,0,0,0,148,2,0,0,9,89,6427,98,0,0
56,4/17/2020,296,6131,19,43,0,0,0,0,148,2,0,0,0,0,6427,0,0,0
56,4/18/2020,305,6217,19,50,0,0,0,0,206,2,0,0,9,86,6522,95,0,7
56,4/19/2020,309,6972,19,50,0,0,0,0,227,2,0,0,4,755,7281,759,0,0
56,4/20/2020,313,7073,19,51,0,0,0,0,233,2,0,0,4,101,7386,105,0,1
56,4/21/2020,320,7301,19,52,0,0,0,0,237,6,0,0,7,228,7621,235,4,1
56,4/22/2020,322,7301,19,52,0,0,0,0,254,6,0,0,2,0,7623,2,0,0
56,4/23/2020,326,7241,0,52,0,0,0,0,275,7,0,0,4,-60,7567,-56,1,0
56,4/24/2020,349,7696,16,54,0,0,0,0,321,7,0,0,23,455,8045,478,0,2
56,4/25/2020,349,7797,16,54,0,0,0,0,321,7,0,0,0,101,8146,101,0,0
56,4/26/2020,362,7797,16,54,0,0,0,0,334,7,0,0,13,0,8159,13,0,0
56,4/27/2020,370,7797,16,54,0,0,0,0,342,7,0,0,8,0,8167,8,0,0
56,4/28/2020,389,8226,16,56,0,0,0,0,343,7,0,0,19,429,8615,448,0,2
56,4/29/2020,536,8681,12,56,0,0,0,0,362,7,0,0,147,455,9217,602,0,0
56,4/30/2020,544,8902,13,56,0,0,0,0,371,7,0,0,8,221,9446,229,0,0
56,5/1/2020,559,9136,13,56,0,0,0,0,373,7,0,0,15,234,9695,249,0,0
56,5/2/2020,566,9463,13,58,0,0,0,0,387,7,0,0,7,327,10029,334,0,2
56,5/3/2020,579,9640,13,60,0,0,0,0,391,7,0,0,13,177,10219,190,0,2
56,5/4/2020,586,9868,13,60,0,0,0,0,391,7,0,0,7,228,10454,235,0,0
56,5/5/2020,596,10319,13,60,0,0,0,0,405,7,0,0,10,451,10915,461,0,0
56,5/6/2020,604,11403,11,60,0,0,0,0,409,7,0,0,8,1084,12007,1092,0,0
56,5/7/2020,631,11403,11,59,0,0,0,0,416,7,0,0,27,0,12034,27,0,-1
56,5/8/2020,635,11403,9,60,0,0,0,0,428,7,0,0,4,0,12038,4,0,1
56,5/9/2020,644,11403,12,64,0,0,0,0,438,7,0,0,9,0,12047,9,0,4
56,5/10/2020,661,11403,12,65,0,0,0,0,443,7,0,0,17,0,12064,17,0,1
56,5/11/2020,662,11403,12,66,0,0,0,0,443,7,0,0,1,0,12065,1,0,1
56,5/12/2020,675,14384,10,67,0,0,0,0,477,7,0,0,13,2981,15059,2994,0,1
56,5/13/2020,675,14384,10,67,0,0,0,0,477,7,0,0,0,0,15059,0,0,0
56,5/14/2020,701,14729,8,67,0,0,0,0,480,7,0,0,26,345,15430,371,0,0
56,5/15/2020,715,15307,8,68,0,0,0,0,487,7,0,0,14,578,16022,592,0,1
56,5/16/2020,716,15678,8,69,0,0,0,0,496,7,0,0,1,371,16394,372,0,1
56,5/17/2020,754,16331,8,70,0,0,0,0,498,8,0,0,38,653,17085,691,1,1
56,5/18/2020,754,16331,8,73,0,0,0,0,498,8,0,0,0,0,17085,0,0,3
56,5/19/2020,766,17084,8,73,0,0,0,0,504,10,0,0,12,753,17850,765,2,0
56,5/20/2020,787,18053,9,74,0,0,0,0,528,11,0,0,21,969,18840,990,1,1
56,5/21/2020,787,18053,8,75,0,0,0,0,534,11,0,0,0,0,18840,0,0,1
56,5/22/2020,803,18621,10,76,0,0,0,0,551,12,0,0,16,568,19424,584,1,1
56,5/23/2020,813,19221,10,77,0,0,0,0,551,12,0,0,10,600,20034,610,0,1
56,5/24/2020,813,19221,10,78,0,0,0,0,556,12,0,0,0,0,20034,0,0,1
56,5/25/2020,838,19551,10,79,0,0,0,0,575,12,0,0,25,330,20389,355,0,1
56,5/26/2020,850,20652,14,82,0,0,0,0,607,13,0,0,12,1101,21502,1113,1,3
56,5/27/2020,850,20652,12,82,0,0,0,0,607,13,0,0,0,0,21502,0,0,0
56,5/28/2020,874,22286,15,82,0,0,0,0,624,15,0,0,24,1634,23160,1658,2,0
56,5/29/2020,891,22378,13,84,0,0,0,0,634,15,0,0,17,92,23269,109,0,2
56,5/30/2020,898,23185,13,85,0,0,0,0,658,16,0,0,7,807,24083,814,1,1
56,5/31/2020,903,23490,13,85,0,0,0,0,658,16,0,0,5,305,24393,310,0,0
56,6/1/2020,910,24237,8,86,0,0,0,0,667,17,0,0,7,747,25147,754,1,1
56,6/2/2020,910,24832,7,86,0,0,0,0,667,17,0,0,0,595,25742,595,0,0
56,6/3/2020,915,25713,4,87,0,0,0,0,714,17,0,0,5,881,26628,886,0,1
56,6/4/2020,915,26074,4,87,0,0,0,0,714,17,0,0,0,361,26989,361,0,0
56,6/5/2020,933,26679,4,90,0,0,0,0,755,17,0,0,18,605,27612,623,0,3
56,6/6/2020,939,27569,4,90,0,0,0,0,757,17,0,0,6,890,28508,896,0,0
56,6/7/2020,947,27804,4,90,0,0,0,0,757,17,0,0,8,235,28751,243,0,0
56,6/8/2020,960,29014,7,91,0,0,0,0,773,17,0,0,13,1210,29974,1223,0,1
56,6/9/2020,970,29366,8,91,0,0,0,0,789,17,0,0,10,352,30336,362,0,0
56,6/10/2020,980,29872,8,92,0,0,0,0,804,18,0,0,10,506,30852,516,1,1
56,6/11/2020,1009,30609,7,92,0,0,0,0,814,18,0,0,29,737,31618,766,0,0
56,6/12/2020,1027,30873,5,92,0,0,0,0,814,18,0,0,18,264,31900,282,0,0
56,6/13/2020,1050,32005,5,93,0,0,0,0,833,18,0,0,23,1132,33055,1155,0,1
56,6/14/2020,1060,32005,5,93,0,0,0,0,834,18,0,0,10,0,33065,10,0,0
56,6/15/2020,1060,31546,4,93,0,0,0,0,834,18,0,0,0,-459,32606,-459,0,0
56,6/16/2020,1089,33324,7,96,0,0,0,0,852,18,0,0,29,1778,34413,1807,0,3
56,6/17/2020,1114,33955,7,97,0,0,0,0,862,18,0,0,25,631,35069,656,0,1
56,6/18/2020,1144,35010,8,97,0,0,0,0,870,18,0,0,30,1055,36154,1085,0,0
56,6/19/2020,1173,35301,8,98,0,0,0,0,889,20,0,0,29,291,36474,320,2,1
56,6/20/2020,1179,26162,8,98,0,0,0,0,896,20,0,0,6,-9139,27341,-9133,0,0
56,6/21/2020,1197,26162,8,100,0,0,0,0,909,20,0,0,18,0,27359,18,0,2
56,6/22/2020,1230,26162,8,105,0,0,0,0,931,20,0,0,33,0,27392,33,0,5
56,6/23/2020,1254,27485,8,109,0,0,0,0,953,20,0,0,24,1323,28739,1347,0,4
56,6/24/2020,1279,28869,7,109,0,0,0,0,966,20,0,0,25,1384,30148,1409,0,0
56,6/25/2020,1326,28869,7,111,0,0,0,0,996,20,0,0,47,0,30195,47,0,2
56,6/26/2020,1368,30406,5,112,0,0,0,0,1033,20,0,0,42,1537,31774,1579,0,1
56,6/27/2020,1392,30406,5,111,0,0,0,0,1054,20,0,0,24,0,31798,24,0,-1
56,6/28/2020,1417,30406,5,112,0,0,0,0,1057,20,0,0,25,0,31823,25,0,1
56,6/29/2020,1450,30406,7,112,0,0,0,0,1070,20,0,0,33,0,31856,33,0,0
56,6/30/2020,1487,32185,6,117,0,0,0,0,1097,20,0,0,37,1779,33672,1816,0,5
56,7/1/2020,1514,32185,9,117,0,0,0,0,1119,20,0,0,27,0,33699,27,0,0
56,7/2/2020,1550,33693,9,119,0,0,0,0,1139,20,0,0,36,1508,35243,1544,0,2
56,7/3/2020,1582,33693,8,119,0,0,0,0,1154,20,0,0,32,0,35275,32,0,0
56,7/4/2020,1606,33693,8,119,0,0,0,0,1169,20,0,0,24,0,35299,24,0,0
56,7/5/2020,1634,33693,8,119,0,0,0,0,1172,20,0,0,28,0,35327,28,0,0
56,7/6/2020,1634,33693,9,119,0,0,0,0,1172,20,0,0,0,0,35327,0,0,0
56,7/7/2020,1711,36078,10,119,0,0,0,0,1274,20,0,0,77,2385,37789,2462,0,0
56,7/8/2020,1740,36078,13,120,0,0,0,0,1291,21,0,0,29,0,37818,29,1,1
56,7/9/2020,1774,37271,12,121,0,0,0,0,1313,21,0,0,34,1193,39045,1227,0,1
56,7/10/2020,1790,38077,12,121,0,0,0,0,1327,21,0,0,16,806,39867,822,0,0
56,7/11/2020,1839,38077,12,123,0,0,0,0,1361,21,0,0,49,0,39916,49,0,2
56,7/12/2020,1862,38077,12,124,0,0,0,0,1372,21,0,0,23,0,39939,23,0,1
56,7/13/2020,1862,38077,17,124,0,0,0,0,1372,21,0,0,0,0,39939,0,0,0
56,7/14/2020,1951,38077,14,128,0,0,0,0,1462,22,0,0,89,0,40028,89,1,4
56,7/15/2020,1985,40929,17,131,0,0,0,0,1506,22,0,0,34,2852,42914,2886,0,3
56,7/16/2020,2026,41426,18,131,0,0,0,0,1540,24,0,0,41,497,43452,538,2,0
56,7/17/2020,2069,41927,19,140,0,0,0,0,1590,24,0,0,43,501,43996,544,0,9
72,3/16/2020,5,9,0,0,0,0,0,0,0,0,0,0,0,0,14,0,0,0
72,3/17/2020,5,13,0,0,0,0,0,0,0,0,0,0,0,4,18,4,0,0
72,3/18/2020,5,31,0,0,0,0,0,0,0,0,0,0,0,18,36,18,0,0
72,3/19/2020,5,56,0,0,0,0,0,0,0,0,0,0,0,25,61,25,0,0
72,3/20/2020,14,114,0,0,0,0,0,0,0,0,0,0,9,58,128,67,0,0
72,3/21/2020,21,143,0,0,0,0,0,0,0,0,0,0,7,29,164,36,0,0
72,3/22/2020,23,183,0,0,0,0,0,0,0,1,0,0,2,40,206,42,1,0
72,3/23/2020,31,189,0,0,0,0,0,0,0,2,0,0,8,6,220,14,1,0
72,3/24/2020,39,268,0,0,0,0,0,0,0,2,0,0,8,79,307,87,0,0
72,3/25/2020,51,317,0,0,0,0,0,0,0,2,0,0,12,49,368,61,0,0
72,3/26/2020,64,377,0,0,0,0,0,0,0,2,0,0,13,60,441,73,0,0
72,3/27/2020,79,519,0,0,0,0,0,0,0,3,0,0,15,142,598,157,1,0
72,3/28/2020,100,739,0,0,0,0,0,0,0,3,0,0,21,220,839,241,0,0
72,3/29/2020,127,841,0,0,0,0,0,0,0,5,0,0,27,102,968,129,2,0
72,3/30/2020,174,931,0,0,0,0,0,0,0,6,0,0,47,90,1105,137,1,0
72,3/31/2020,239,1195,0,0,0,0,0,0,0,8,0,0,65,264,1434,329,2,0
72,4/1/2020,286,1409,0,0,0,0,0,0,0,11,0,0,47,214,1695,261,3,0
72,4/2/2020,316,1604,0,0,0,0,0,0,0,12,0,0,30,195,1920,225,1,0
72,4/3/2020,378,2049,0,0,0,0,0,0,0,15,0,0,62,445,2427,507,3,0
72,4/4/2020,452,2605,0,0,0,0,0,0,0,18,0,0,74,556,3057,630,3,0
72,4/5/2020,475,3073,0,0,0,0,0,0,0,20,0,0,23,468,3548,491,2,0
72,4/6/2020,513,3432,0,0,0,0,0,0,0,21,0,0,38,359,3945,397,1,0
72,4/7/2020,573,3966,0,0,0,0,0,0,0,23,0,0,60,534,4539,594,2,0
72,4/8/2020,620,4266,0,0,0,0,0,0,0,24,0,0,47,300,4886,347,1,0
72,4/9/2020,683,4703,0,0,0,0,0,0,0,33,0,0,63,437,5386,500,9,0
72,4/10/2020,725,5121,0,0,0,0,0,0,0,39,0,0,42,418,5846,460,6,0
72,4/11/2020,788,5583,0,0,0,0,0,0,0,42,0,0,63,462,6371,525,3,0
72,4/12/2020,897,5819,0,0,0,0,0,0,0,44,0,0,109,236,6716,345,2,0
72,4/13/2020,903,5960,0,0,0,0,0,0,0,45,0,0,6,141,6863,147,1,0
72,4/14/2020,923,6284,0,0,0,0,0,0,0,45,0,0,20,324,7207,344,0,0
72,4/15/2020,974,6825,0,0,0,0,0,0,0,51,0,0,51,541,7799,592,6,0
72,4/16/2020,1043,7315,0,0,0,0,0,0,0,56,0,0,69,490,8358,559,5,0
72,4/17/2020,1068,7864,0,0,0,0,0,0,0,58,0,0,25,549,8932,574,2,0
72,4/18/2020,1118,8055,165,0,0,0,0,0,0,60,0,0,50,191,9173,241,2,0
72,4/19/2020,1213,8280,160,0,0,0,0,0,0,62,0,0,95,225,9493,320,2,0
72,4/20/2020,1252,8486,151,0,0,0,0,0,0,63,0,0,39,206,9738,245,1,0
72,4/21/2020,1298,8789,117,0,0,0,0,0,0,64,0,0,46,303,10087,349,1,0
72,4/22/2020,915,8842,140,0,0,0,0,0,0,67,0,0,-383,53,9757,-330,3,0
72,4/23/2020,915,9313,154,0,0,0,0,0,0,69,0,0,0,471,10228,471,2,0
72,4/24/2020,1276,9313,172,0,0,0,0,0,0,77,0,0,361,0,10589,361,8,0
72,4/25/2020,1307,9313,137,0,0,0,0,0,0,83,0,0,31,0,10620,31,6,0
72,4/26/2020,1371,9313,146,0,0,0,0,0,0,84,0,0,64,0,10684,64,1,0
72,4/27/2020,1389,9313,140,0,0,0,0,0,0,84,0,0,18,0,10702,18,0,0
72,4/28/2020,1400,9313,132,0,0,0,0,0,0,86,0,0,11,0,10713,11,2,0
72,4/29/2020,1433,9313,125,0,0,0,0,0,0,86,51,0,33,0,10746,33,0,0
72,4/30/2020,1539,9313,201,0,0,0,0,0,0,92,51,0,106,0,10852,106,6,0
72,5/1/2020,1575,9313,200,0,0,0,0,0,0,92,51,0,36,0,10888,36,0,0
72,5/2/2020,1757,9313,187,0,0,0,0,0,0,95,53,0,182,0,11070,182,3,0
72,5/3/2020,1808,9313,171,0,0,0,0,0,0,97,53,0,51,0,11121,51,2,0
72,5/4/2020,1843,9313,152,0,0,0,0,0,0,97,0,0,35,0,11156,35,0,0
72,5/5/2020,1924,9313,140,0,0,0,0,0,0,99,0,0,81,0,11237,81,2,0
72,5/6/2020,1968,0,144,0,0,0,0,0,0,99,0,0,44,-9313,1968,-9269,0,0
72,5/7/2020,2031,0,164,0,0,0,0,0,0,102,0,0,63,0,2031,63,3,0
72,5/8/2020,2156,0,161,0,0,0,10,0,0,107,0,0,125,0,2156,125,5,0
72,5/9/2020,2173,0,148,0,0,0,7,0,0,108,0,0,17,0,2173,17,1,0
72,5/10/2020,2198,0,143,0,0,0,0,0,0,111,0,0,25,0,2198,25,3,0
72,5/11/2020,2256,0,159,0,0,0,0,0,0,113,0,0,58,0,2256,58,2,0
72,5/12/2020,2299,0,127,0,0,0,0,0,0,114,58,0,43,0,2299,43,1,0
72,5/13/2020,2329,0,142,0,10,0,6,0,0,115,58,0,30,0,2329,30,1,0
72,5/14/2020,2427,0,159,0,18,0,5,0,0,117,58,0,98,0,2427,98,2,0
72,5/15/2020,2542,0,147,0,18,0,3,0,0,122,63,0,115,0,2542,115,5,0
72,5/16/2020,2589,0,144,0,15,0,5,0,0,122,59,0,47,0,2589,47,0,0
72,5/17/2020,2646,0,150,0,24,0,5,0,0,123,60,0,57,0,2646,57,1,0
72,5/18/2020,2710,0,147,0,17,0,4,0,0,124,60,0,64,0,2710,64,1,0
72,5/19/2020,2805,0,121,0,20,0,8,0,0,124,60,0,95,0,2805,95,0,0
72,5/20/2020,2866,0,110,0,20,0,5,0,0,125,66,0,61,0,2866,61,1,0
72,5/21/2020,2913,40488,114,0,13,0,7,0,0,126,60,66,47,40488,43401,40535,1,0
72,5/22/2020,3030,40488,96,0,12,0,6,0,0,126,60,66,117,0,43518,117,0,0
72,5/23/2020,3100,40488,106,0,14,0,5,0,0,127,61,66,70,0,43588,70,1,0
72,5/24/2020,3189,40488,106,0,13,0,7,0,0,127,61,66,89,0,43677,89,0,0
72,5/25/2020,3260,40488,112,0,16,0,8,0,0,129,61,68,71,0,43748,71,2,0
72,5/26/2020,3324,40488,104,0,14,0,4,0,0,129,61,68,64,0,43812,64,0,0
72,5/27/2020,3397,40488,105,0,8,0,4,0,0,129,61,68,73,0,43885,73,0,0
72,5/28/2020,3486,60422,120,0,12,0,5,0,0,131,61,70,89,19934,63908,20023,2,0
72,5/29/2020,3647,60422,101,0,12,0,5,0,0,132,62,70,161,0,64069,161,1,0
72,5/30/2020,3718,60422,106,0,6,0,5,0,0,133,62,71,71,0,64140,71,1,0
72,5/31/2020,3776,60422,99,0,9,0,1,0,0,136,63,73,58,0,64198,58,3,0
72,6/1/2020,3873,60422,99,0,9,0,4,0,0,136,63,73,97,0,64295,97,0,0
72,6/2/2020,3935,60422,106,0,17,0,10,0,0,138,63,75,62,0,64357,62,2,0
72,6/3/2020,4023,60422,107,0,12,0,7,0,0,140,63,77,88,0,64445,88,2,0
72,6/4/2020,4508,60422,114,0,15,0,9,0,0,140,63,77,485,0,64930,485,0,0
72,6/5/2020,4620,60422,116,0,9,0,7,0,0,141,63,78,112,0,65042,112,1,0
72,6/6/2020,4915,88685,100,0,7,0,4,0,0,142,63,79,295,28263,93600,28558,1,0
72,6/7/2020,4985,88685,105,0,6,0,7,0,0,142,63,79,70,0,93670,70,0,0
72,6/8/2020,5046,88685,107,0,8,0,7,0,0,142,63,79,61,0,93731,61,0,0
72,6/9/2020,5185,88685,95,0,9,0,6,0,0,142,63,79,139,0,93870,139,0,0
72,6/10/2020,5329,88685,97,0,8,0,5,0,0,143,63,80,144,0,94014,144,1,0
72,6/11/2020,5352,88685,91,0,7,0,4,0,0,144,56,88,23,0,94037,23,1,0
72,6/12/2020,5536,113280,92,0,7,0,4,0,0,146,56,90,184,24595,118816,24779,2,0
72,6/13/2020,5690,113280,117,0,4,0,3,0,0,146,56,90,154,0,118970,154,0,0
72,6/14/2020,5811,113280,110,0,6,0,2,0,0,147,57,90,121,0,119091,121,1,0
72,6/15/2020,5890,113280,104,0,8,0,2,0,0,147,57,90,79,0,119170,79,0,0
72,6/16/2020,5951,113280,94,0,9,0,1,0,0,147,57,90,61,0,119231,61,0,0
72,6/17/2020,6003,113280,78,0,8,0,1,0,0,147,57,90,52,0,119283,52,0,0
72,6/18/2020,6111,113280,73,0,9,0,5,0,0,147,57,90,108,0,119391,108,0,0
72,6/19/2020,6195,113280,78,0,7,0,3,0,0,147,57,90,84,0,119475,84,0,0
72,6/20/2020,6463,113280,83,0,10,0,4,0,0,147,57,90,268,0,119743,268,0,0
72,6/21/2020,6525,113280,71,0,13,0,5,0,0,149,57,92,62,0,119805,62,2,0
72,6/22/2020,6564,113280,70,0,10,0,3,0,0,149,57,92,39,0,119844,39,0,0
72,6/23/2020,6685,113280,77,0,9,0,2,0,0,149,57,92,121,0,119965,121,0,0
72,6/24/2020,6820,113280,80,0,9,0,2,0,0,149,57,92,135,0,120100,135,0,0
72,6/25/2020,6877,113280,85,0,12,0,4,0,0,151,57,94,57,0,120157,57,2,0
72,6/26/2020,6922,113280,89,0,9,0,7,0,0,151,57,94,45,0,120202,45,0,0
72,6/27/2020,7066,113280,105,0,10,0,5,0,0,152,58,94,144,0,120346,144,1,0
72,6/28/2020,7189,113280,99,0,8,0,5,0,0,153,59,94,123,0,120469,123,1,0
72,6/29/2020,7250,192686,104,0,8,0,1,0,0,153,59,94,61,79406,199936,79467,0,0
72,6/30/2020,7465,192686,102,0,9,0,2,0,0,153,59,94,215,0,200151,215,0,0
72,7/1/2020,7537,192686,121,0,7,0,3,0,0,153,59,94,72,0,200223,72,0,0
72,7/2/2020,7608,192686,97,0,8,0,3,0,0,153,59,94,71,0,200294,71,0,0
72,7/3/2020,7683,192686,104,0,11,0,6,0,0,154,60,94,75,0,200369,75,1,0
72,7/4/2020,7787,192686,100,0,8,0,4,0,0,155,60,95,104,0,200473,104,1,0
72,7/5/2020,7916,192686,118,0,9,0,5,0,0,155,60,95,129,0,200602,129,0,0
72,7/6/2020,8585,192686,115,0,18,0,11,0,0,155,60,95,669,0,201271,669,0,0
72,7/7/2020,8714,192686,122,0,19,0,7,0,0,157,62,95,129,0,201400,129,2,0
72,7/8/2020,8745,192686,127,0,9,0,10,0,0,159,64,95,31,0,201431,31,2,0
72,7/9/2020,8862,255766,147,0,11,0,7,0,0,159,64,95,117,63080,264628,63197,0,0
72,7/10/2020,9137,255766,140,0,12,0,10,0,0,159,64,95,275,0,264903,275,0,0
72,7/11/2020,9366,192686,174,0,12,0,7,0,0,167,71,96,229,-63080,202052,-62851,8,0
72,7/12/2020,9654,192686,174,0,12,0,11,0,0,167,71,96,288,0,202340,288,0,0
72,7/13/2020,10010,192686,159,0,15,0,8,0,0,167,71,96,356,0,202696,356,0,0
72,7/14/2020,10123,192686,206,0,14,0,9,0,0,169,73,96,113,0,202809,113,2,0
72,7/15/2020,10379,192686,254,0,18,0,11,0,0,171,75,96,256,0,203065,256,2,0
72,7/16/2020,10574,192686,280,0,25,0,14,0,0,172,75,97,195,0,203260,195,1,0
72,7/17/2020,11120,192686,302,0,34,0,27,0,0,177,80,97,546,0,203806,546,5,0
1,3/7/2020,0,0,0,0,0,0,0,0,0,0,0,0,0,0,0,0,0,0
1,3/8/2020,0,0,0,0,0,0,0,0,0,0,0,0,0,0,0,0,0,0
1,3/9/2020,0,0,0,0,0,0,0,0,0,0,0,0,0,0,0,0,0,0
1,3/10/2020,0,0,0,0,0,0,0,0,0,0,0,0,0,0,0,0,0,0
1,3/11/2020,0,10,0,0,0,0,0,0,0,0,0,0,0,10,10,10,0,0
1,3/12/2020,0,10,0,0,0,0,0,0,0,0,0,0,0,0,10,0,0,0
1,3/13/2020,1,11,0,0,0,0,0,0,0,0,0,0,1,1,12,2,0,0
1,3/14/2020,6,22,0,0,0,0,0,0,0,0,0,0,5,11,28,16,0,0
1,3/15/2020,12,28,0,0,0,0,0,0,0,0,0,0,6,6,40,12,0,0
1,3/16/2020,28,28,0,0,0,0,0,0,0,0,0,0,16,0,56,16,0,0
1,3/17/2020,36,28,0,0,0,0,0,0,0,0,0,0,8,0,64,8,0,0
1,3/18/2020,46,28,0,0,0,0,0,0,0,0,0,0,10,0,74,10,0,0
1,3/19/2020,68,28,0,0,0,0,0,0,0,0,0,0,22,0,96,22,0,0
1,3/20/2020,81,28,0,0,0,0,0,0,0,0,0,0,13,0,109,13,0,0
1,3/21/2020,124,28,0,0,0,0,0,0,0,0,0,0,43,0,152,43,0,0
1,3/22/2020,138,1464,0,0,0,0,0,0,0,0,0,0,14,1436,1602,1450,0,0
1,3/23/2020,167,1665,0,0,0,0,0,0,0,0,0,0,29,201,1832,230,0,0
1,3/24/2020,215,2106,0,0,0,0,0,0,0,0,0,0,48,441,2321,489,0,0
1,3/25/2020,283,2529,0,0,0,0,0,0,0,0,0,0,68,423,2812,491,0,0
1,3/26/2020,506,3593,0,0,0,0,0,0,0,1,0,0,223,1064,4099,1287,1,0
1,3/27/2020,587,4184,0,0,0,0,0,0,0,3,0,0,81,591,4771,672,2,0
1,3/28/2020,696,4184,0,0,0,0,0,0,0,3,0,0,109,0,4880,109,0,0
1,3/29/2020,806,4184,0,0,0,0,0,0,0,4,0,0,110,0,4990,110,1,0
1,3/30/2020,859,5694,0,0,0,0,0,0,0,6,0,0,53,1510,6553,1563,2,0
1,3/31/2020,981,6298,0,0,0,0,0,0,0,13,0,0,122,604,7279,726,7,0
1,4/1/2020,1077,6697,0,0,0,0,0,0,0,26,0,0,96,399,7774,495,13,0
1,4/2/2020,1233,7503,0,0,0,0,0,0,0,32,0,0,156,806,8736,962,6,0
1,4/3/2020,1432,8187,0,0,0,0,0,0,0,35,0,0,199,684,9619,883,3,0
1,4/4/2020,1580,9273,0,212,0,0,0,0,0,43,0,0,148,1086,10853,1234,8,212
1,4/5/2020,1796,11282,0,231,0,0,0,0,0,45,0,0,216,2009,13078,2225,2,19
1,4/6/2020,1968,12797,0,240,0,0,0,0,0,50,0,0,172,1515,14765,1687,5,9
1,4/7/2020,2119,12797,0,271,0,0,0,0,0,56,0,0,151,0,14916,151,6,31
1,4/8/2020,2369,16753,0,314,0,0,0,0,0,66,0,0,250,3956,19122,4206,10,43
1,4/9/2020,2769,18058,0,333,0,0,0,0,0,74,0,0,400,1305,20827,1705,8,19
1,4/10/2020,2968,18058,0,368,0,0,0,0,0,80,0,0,199,0,21026,199,6,35
1,4/11/2020,3191,18058,0,402,0,177,0,113,0,91,0,0,223,0,21249,223,11,34
1,4/12/2020,3525,18058,0,437,0,189,0,119,0,93,0,0,334,0,21583,334,2,35
1,4/13/2020,3734,25448,0,457,0,189,0,119,0,99,0,0,209,7390,29182,7599,6,20
1,4/14/2020,3876,29241,0,493,0,210,0,132,0,110,0,0,142,3793,33117,3935,11,36
1,4/15/2020,4113,29964,0,525,0,219,0,134,0,121,0,0,237,723,34077,960,11,32
1,4/16/2020,4345,32046,0,553,0,227,0,137,0,133,0,0,232,2082,36391,2314,12,28
1,4/17/2020,4530,33318,0,594,0,247,0,148,0,144,0,0,185,1272,37848,1457,11,41
1,4/18/2020,4655,37883,0,620,0,247,0,148,0,146,0,0,125,4565,42538,4690,2,26
1,4/19/2020,4837,40875,0,641,0,260,0,157,0,154,0,0,182,2992,45712,3174,8,21
1,4/20/2020,5025,40875,0,641,0,260,0,157,0,167,0,0,188,0,45900,188,13,0
1,4/21/2020,5231,43295,0,699,0,260,0,157,0,177,0,0,206,2420,48526,2626,10,58
1,4/22/2020,5465,43295,0,730,0,288,0,170,0,194,0,0,234,0,48760,234,17,31
1,4/23/2020,5778,46863,0,768,0,288,0,170,0,197,0,0,313,3568,52641,3881,3,38
1,4/24/2020,5832,46863,0,768,0,288,0,170,0,197,0,0,54,0,52695,54,0,0
1,4/25/2020,6137,65207,0,839,0,288,0,170,0,212,0,0,305,18344,71344,18649,15,71
1,4/26/2020,6270,67281,0,845,0,288,0,170,0,216,0,0,133,2074,73551,2207,4,6
1,4/27/2020,6499,67498,0,872,0,335,0,195,0,222,0,0,229,217,73997,446,6,27
1,4/28/2020,6687,69140,0,911,0,335,0,195,0,242,0,0,188,1642,75827,1830,20,39
1,4/29/2020,6842,73607,0,945,0,335,0,195,0,245,0,0,155,4467,80449,4622,3,34
1,4/30/2020,7019,80177,0,978,0,335,0,195,0,269,0,0,177,6570,87196,6747,24,33
1,5/1/2020,7158,84775,0,1008,0,335,0,195,0,279,0,0,139,4598,91933,4737,10,30
1,5/2/2020,7434,84775,0,1023,0,335,0,195,0,288,0,0,276,0,92209,276,9,15
1,5/3/2020,7725,84775,0,1035,0,403,0,242,0,290,0,0,291,0,92500,291,2,12
1,5/4/2020,8025,95092,0,1064,0,411,0,247,0,296,0,0,300,10317,103117,10617,6,29
1,5/5/2020,8285,98481,0,1107,0,428,0,255,0,313,0,0,260,3389,106766,3649,17,43
1,5/6/2020,8581,100935,0,1158,0,442,0,264,0,340,0,0,296,2454,109516,2750,27,51
1,5/7/2020,8898,106275,0,1178,0,448,0,266,0,349,0,0,317,5340,115173,5657,9,20
1,5/8/2020,9221,110893,0,1207,0,454,0,266,0,375,0,0,323,4618,120114,4941,26,29
1,5/9/2020,9567,115927,0,1228,0,459,0,272,0,388,0,0,346,5034,125494,5380,13,21
1,5/10/2020,9777,117644,0,1240,0,460,0,274,0,393,0,0,210,1717,127421,1927,5,12
1,5/11/2020,10009,119435,0,1256,0,463,0,276,0,401,0,0,232,1791,129444,2023,8,16
1,5/12/2020,10310,122908,0,1287,0,468,0,280,0,429,429,0,301,3473,133218,3774,28,31
1,5/13/2020,10617,125755,0,1317,0,477,0,284,0,449,449,0,307,2847,136372,3154,20,30
1,5/14/2020,10968,131017,0,1350,0,489,0,291,0,467,467,0,351,5262,141985,5613,18,33
1,5/15/2020,11216,134847,0,1377,0,497,0,293,0,476,476,0,248,3830,146063,4078,9,27
1,5/16/2020,11523,141971,0,1387,0,501,0,295,0,485,485,0,307,7124,153494,7431,9,10
1,5/17/2020,11771,144579,0,1392,0,504,0,296,0,488,488,0,248,2608,156350,2856,3,5
1,5/18/2020,12086,145037,0,1416,0,512,0,302,0,489,489,0,315,458,157123,773,1,24
1,5/19/2020,12376,145190,0,1453,0,517,0,306,0,504,504,0,290,153,157566,443,15,37
1,5/20/2020,12744,151706,0,1493,0,524,0,309,0,517,517,0,368,6516,164450,6884,13,40
1,5/21/2020,13119,157620,0,1528,0,526,0,311,0,529,529,0,375,5914,170739,6289,12,35
1,5/22/2020,13563,164205,0,1561,0,531,0,315,7951,537,537,0,444,6585,177768,7029,8,33
1,5/23/2020,13938,168738,0,1589,0,538,0,319,7951,546,546,0,375,4533,182676,4908,9,28
1,5/24/2020,14327,171472,0,1612,0,537,0,320,7951,551,551,0,389,2734,185799,3123,5,23
1,5/25/2020,14730,175585,0,1629,0,543,0,323,7951,562,562,0,403,4113,190315,4516,11,17
1,5/26/2020,15396,178363,0,1671,0,551,0,327,7951,575,575,0,666,2778,193759,3444,13,42
1,5/27/2020,15843,179951,0,1719,0,560,0,334,7951,581,581,0,447,1588,195794,2035,6,48
1,5/28/2020,16310,184171,0,1765,0,566,0,338,9355,590,590,0,467,4220,200481,4687,9,46
1,5/29/2020,16823,192060,0,1800,0,577,0,344,9355,605,605,0,513,7889,208883,8402,15,35
1,5/30/2020,17359,194842,0,1826,0,583,0,349,9355,618,618,0,536,2782,212201,3318,13,26
1,5/31/2020,17903,199650,0,1844,0,589,0,355,9355,631,629,2,544,4808,217553,5352,13,18
1,6/1/2020,18363,205160,0,1856,0,591,0,355,9355,646,644,2,460,5510,223523,5970,15,12
1,6/2/2020,18642,205160,0,1879,0,591,0,355,9355,651,649,2,279,0,223802,279,5,23
1,6/3/2020,18851,212743,0,1900,0,591,0,355,11395,653,651,2,209,7583,231594,7792,2,21
1,6/4/2020,19072,216227,0,1929,0,601,0,357,11395,653,651,2,221,3484,235299,3705,0,29
1,6/5/2020,19387,220086,0,1949,0,603,0,358,11395,676,672,4,315,3859,239473,4174,23,20
1,6/6/2020,20043,225601,0,1993,0,612,0,363,11395,689,685,4,656,5515,245644,6171,13,44
1,6/7/2020,20500,239066,0,2022,0,615,0,364,11395,692,688,4,457,13465,259566,13922,3,29
1,6/8/2020,20925,239066,0,2054,0,623,0,371,11395,718,714,4,425,0,259991,425,26,32
1,6/9/2020,21422,246317,600,2087,0,631,0,375,11395,729,725,4,497,7251,267739,7748,11,33
1,6/10/2020,21989,251068,629,2129,0,646,0,378,13508,744,739,5,567,4751,273057,5318,15,42
1,6/11/2020,22845,255981,647,2165,0,650,0,380,13508,755,750,5,856,4913,278826,5769,11,36
1,6/12/2020,23710,262675,622,2202,0,658,0,384,13508,769,764,5,865,6694,286385,7559,14,37
1,6/13/2020,24601,268651,622,2241,0,672,0,395,13508,773,768,5,891,5976,293252,6867,4,39
1,6/14/2020,25615,271840,540,2255,0,675,0,395,13508,773,768,5,1014,3189,297455,4203,0,14
1,6/15/2020,26272,276402,546,2259,0,676,0,395,13508,774,769,5,657,4562,302674,5219,1,4
1,6/16/2020,26912,278512,678,2315,0,682,0,399,13508,785,779,6,640,2110,305424,2750,11,56
1,6/17/2020,27312,283411,677,2352,0,687,0,401,15974,790,784,6,400,4899,310723,5299,5,37
1,6/18/2020,28206,294328,663,2373,0,695,0,405,15974,810,801,9,894,10917,322534,11811,20,21
1,6/19/2020,29002,302323,674,2416,0,710,0,415,15974,822,812,10,796,7995,331325,8791,12,43
1,6/20/2020,29549,309974,628,2443,0,717,0,418,15974,838,828,10,547,7651,339523,8198,16,27
1,6/21/2020,30021,314657,593,2460,0,721,0,424,15974,839,829,10,472,4683,344678,5155,1,17
1,6/22/2020,30454,318656,658,2471,0,725,0,424,15974,841,831,10,433,3999,349110,4432,2,11
1,6/23/2020,31097,322941,680,2521,0,737,0,430,15974,864,854,10,643,4285,354038,4928,23,50
1,6/24/2020,32064,326695,667,2567,0,749,0,441,18866,891,879,12,967,3754,358759,4721,27,46
1,6/25/2020,33206,336252,693,2612,0,761,0,447,18866,896,880,16,1142,9557,369458,10699,5,45
1,6/26/2020,34183,344140,658,2653,0,772,0,450,18866,907,887,20,977,7888,378323,8865,11,41
1,6/27/2020,35083,348943,655,2697,0,789,0,453,18866,919,898,21,900,4803,384026,5703,12,44
1,6/28/2020,35441,350839,655,2703,0,790,0,454,18866,919,898,21,358,1896,386280,2254,0,6
1,6/29/2020,37175,356118,715,2725,0,801,0,457,18866,929,905,24,1734,5279,393293,7013,10,22
1,6/30/2020,38045,368607,776,2769,0,806,0,458,18866,950,926,24,870,12489,406652,13359,21,44
1,7/1/2020,38962,374991,797,2803,0,814,0,464,18866,972,947,25,917,6384,413953,7301,22,34
1,7/2/2020,40111,379617,843,2835,0,826,0,468,22082,985,961,24,1149,4626,419728,5775,13,32
1,7/3/2020,41865,388766,812,2883,0,838,0,474,22082,1006,983,23,1754,9149,430631,10903,21,48
1,7/4/2020,42862,399226,800,2906,0,843,0,473,22082,1007,984,23,997,10460,442088,11457,1,23
1,7/5/2020,43953,405933,885,2909,0,843,0,473,22082,1007,984,23,1091,6707,449886,7798,0,3
1,7/6/2020,44878,410217,1016,2914,0,843,0,473,22082,1007,984,23,925,4284,455095,5209,0,5
1,7/7/2020,45785,415579,1073,2961,0,858,0,479,22082,1033,1007,26,907,5362,461364,6269,26,47
1,7/8/2020,46962,421330,1110,3006,0,871,0,486,22082,1058,1032,26,1177,5751,468292,6928,25,45
1,7/9/2020,49174,421330,1125,3039,0,877,0,490,25783,1068,1042,26,2212,0,470504,2212,10,33
1,7/10/2020,50508,441708,1183,3089,0,888,0,493,25783,1104,1077,27,1334,20378,492216,21712,36,50
1,7/11/2020,51947,450073,1068,6745,0,904,0,496,25783,1114,1086,28,1439,8365,502020,9804,10,3656
1,7/12/2020,53587,457919,1068,6745,0,911,0,503,25783,1121,1093,28,1640,7846,511506,9486,7,0
1,7/13/2020,55545,464059,1335,6745,0,919,0,505,25783,1124,1096,28,1958,6140,519604,8098,3,0
1,7/14/2020,57255,471834,1353,7123,0,931,0,511,25783,1164,1136,28,1710,7775,529089,9485,40,378
1,7/15/2020,59067,481982,1362,7291,0,941,0,514,29736,1211,1183,28,1812,10148,541049,11960,47,168
1,7/16/2020,61088,490021,1362,7584,0,950,0,516,29736,1230,1200,30,2021,8039,551109,10060,19,293
1,7/17/2020,63091,500024,1416,7584,0,967,0,521,29736,1265,1232,33,2003,10003,563115,12006,35,0
2,3/6/2020,0,8,0,0,0,0,0,0,0,0,0,0,0,0,8,0,0,0
2,3/7/2020,0,12,0,0,0,0,0,0,0,0,0,0,0,4,12,4,0,0
2,3/8/2020,0,14,0,0,0,0,0,0,0,0,0,0,0,2,14,2,0,0
2,3/9/2020,0,23,0,0,0,0,0,0,0,0,0,0,0,9,23,9,0,0
2,3/10/2020,0,23,0,0,0,0,0,0,0,0,0,0,0,0,23,0,0,0
2,3/11/2020,0,46,0,0,0,0,0,0,0,0,0,0,0,23,46,23,0,0
2,3/12/2020,0,46,0,0,0,0,0,0,0,0,0,0,0,0,46,0,0,0
2,3/13/2020,1,59,0,0,0,0,0,0,0,0,0,0,1,13,60,14,0,0
2,3/14/2020,1,143,0,0,0,0,0,0,0,0,0,0,0,84,144,84,0,0
2,3/15/2020,1,143,0,0,0,0,0,0,0,0,0,0,0,0,144,0,0,0
2,3/16/2020,1,143,0,0,0,0,0,0,0,0,0,0,0,0,144,0,0,0
2,3/17/2020,3,334,0,0,0,0,0,0,0,0,0,0,2,191,337,193,0,0
2,3/18/2020,6,406,0,0,0,0,0,0,0,0,0,0,3,72,412,75,0,0
2,3/19/2020,6,432,0,0,0,0,0,0,0,0,0,0,0,26,438,26,0,0
2,3/20/2020,12,686,0,0,0,0,0,0,0,0,0,0,6,254,698,260,0,0
2,3/21/2020,14,758,0,0,0,0,0,0,0,0,0,0,2,72,772,74,0,0
2,3/22/2020,22,946,0,0,0,0,0,0,0,0,0,0,8,188,968,196,0,0
2,3/23/2020,22,946,0,0,0,0,0,0,0,0,0,0,0,0,968,0,0,0
2,3/24/2020,36,986,0,0,0,0,0,0,0,0,0,0,14,40,1022,54,0,0
2,3/25/2020,42,1649,0,1,0,0,0,0,0,1,0,0,6,663,1691,669,1,1
2,3/26/2020,59,1801,0,3,0,0,0,0,0,1,0,0,17,152,1860,169,0,2
2,3/27/2020,69,2319,0,3,0,0,0,0,0,1,0,0,10,518,2388,528,0,0
2,3/28/2020,85,2836,0,5,0,0,0,0,0,2,0,0,16,517,2921,533,1,2
2,3/29/2020,102,3232,0,6,0,0,0,0,0,2,0,0,17,396,3334,413,0,1
2,3/30/2020,114,3540,0,7,0,0,0,0,0,3,0,0,12,308,3654,320,1,1
2,3/31/2020,119,3594,0,7,0,0,0,0,0,3,0,0,5,54,3713,59,0,0
2,4/1/2020,133,4470,0,9,0,0,0,0,0,3,0,0,14,876,4603,890,0,2
2,4/2/2020,143,4879,0,9,0,0,0,0,0,3,0,0,10,409,5022,419,0,0
2,4/3/2020,157,5859,0,15,0,0,0,0,0,3,0,0,14,980,6016,994,0,6
2,4/4/2020,171,5869,0,16,0,0,0,0,0,5,0,0,14,10,6040,24,2,1
2,4/5/2020,185,6099,0,20,0,0,0,0,0,6,0,0,14,230,6284,244,1,4
2,4/6/2020,191,6692,0,23,0,0,0,0,0,6,0,0,6,593,6883,599,0,3
2,4/7/2020,213,6700,0,23,0,0,0,0,29,6,0,0,22,8,6913,30,0,0
2,4/8/2020,226,6842,0,27,0,0,0,0,32,7,0,0,13,142,7068,155,1,4
2,4/9/2020,235,6988,0,27,0,0,0,0,49,7,0,0,9,146,7223,155,0,0
2,4/10/2020,246,7186,0,28,0,0,0,0,55,7,0,0,11,198,7432,209,0,1
2,4/11/2020,257,7475,0,31,0,0,0,0,63,8,0,0,11,289,7732,300,1,3
2,4/12/2020,272,7766,0,31,0,0,0,0,66,8,0,0,15,291,8038,306,0,0
2,4/13/2020,277,7553,0,32,0,0,0,0,85,8,0,0,5,-213,7830,-208,0,1
2,4/14/2020,285,8063,0,32,0,0,0,0,98,9,0,0,8,510,8348,518,1,0
2,4/15/2020,293,8371,0,34,0,0,0,0,106,9,0,0,8,308,8664,316,0,2
2,4/16/2020,300,8435,0,35,0,0,0,0,110,9,0,0,7,64,8735,71,0,1
2,4/17/2020,309,9141,0,36,0,0,0,0,128,9,0,0,9,706,9450,715,0,1
2,4/18/2020,314,9341,39,36,0,0,0,0,147,9,0,0,5,200,9655,205,0,0
2,4/19/2020,319,9576,37,36,0,0,0,0,153,9,0,0,5,235,9895,240,0,0
2,4/20/2020,321,9803,46,36,0,0,0,0,161,9,0,0,2,227,10124,229,0,0
2,4/21/2020,329,10790,42,36,0,0,0,0,168,9,0,0,8,987,11119,995,0,0
2,4/22/2020,335,11824,39,36,0,0,0,0,196,9,0,0,6,1034,12159,1040,0,0
2,4/23/2020,337,11824,42,0,0,0,0,0,209,9,0,0,2,0,12161,2,0,-36
2,4/24/2020,339,11942,36,0,0,0,0,0,208,9,0,0,2,118,12281,120,0,0
2,4/25/2020,339,15393,32,0,0,0,0,0,217,9,0,0,0,3451,15732,3451,0,0
2,4/26/2020,341,15836,14,0,0,0,0,0,217,9,0,0,2,443,16177,445,0,0
2,4/27/2020,345,15911,10,0,0,0,0,0,218,9,0,0,4,75,16256,79,0,0
2,4/28/2020,351,16738,16,0,0,0,0,0,228,9,0,0,6,827,17089,833,0,0
2,4/29/2020,355,18764,14,0,0,0,0,0,240,9,0,0,4,2026,19119,2030,0,0
2,4/30/2020,355,18764,19,0,0,0,0,0,252,9,0,0,0,0,19119,0,0,0
2,5/1/2020,364,19961,25,0,0,0,0,0,254,9,0,0,9,1197,20325,1206,0,0
2,5/2/2020,365,21034,10,0,0,0,0,0,261,9,0,0,1,1073,21399,1074,0,0
2,5/3/2020,368,21210,12,0,0,0,0,0,262,9,0,0,3,176,21578,179,0,0
2,5/4/2020,370,21353,12,0,0,0,0,0,263,9,0,0,2,143,21723,145,0,0
2,5/5/2020,371,22321,13,0,0,0,0,0,277,9,0,0,1,968,22692,969,0,0
2,5/6/2020,372,23283,8,0,0,0,0,0,284,10,0,0,1,962,23655,963,1,0
2,5/7/2020,374,23967,12,0,0,0,0,0,291,10,0,0,2,684,24341,686,0,0
2,5/8/2020,377,25096,16,0,0,0,0,0,305,10,0,0,3,1129,25473,1132,0,0
2,5/9/2020,378,26071,8,0,0,0,0,0,318,10,0,0,1,975,26449,976,0,0
2,5/10/2020,379,26985,8,0,0,0,0,0,324,10,0,0,1,914,27364,915,0,0
2,5/11/2020,381,28299,7,0,0,0,0,0,328,10,0,0,2,1314,28680,1316,0,0
2,5/12/2020,383,29578,10,0,0,0,0,0,334,10,10,0,2,1279,29961,1281,0,0
2,5/13/2020,383,30266,12,0,0,0,0,0,338,10,10,0,0,688,30649,688,0,0
2,5/14/2020,387,31375,12,0,0,0,0,0,339,10,10,0,4,1109,31762,1113,0,0
2,5/15/2020,388,32030,8,0,0,0,0,0,343,10,10,0,1,655,32418,656,0,0
2,5/16/2020,392,32889,10,0,0,0,0,0,344,10,10,0,4,859,33281,863,0,0
2,5/17/2020,396,34255,13,0,0,0,0,0,344,10,10,0,4,1366,34651,1370,0,0
2,5/18/2020,399,35212,9,0,0,0,0,0,345,10,10,0,3,957,35611,960,0,0
2,5/19/2020,399,35981,16,0,0,0,0,0,348,10,10,0,0,769,36380,769,0,0
2,5/20/2020,402,36643,16,0,0,0,0,0,352,10,10,0,3,662,37045,665,0,0
2,5/21/2020,402,39143,19,0,0,0,0,0,356,10,10,0,0,2500,39545,2500,0,0
2,5/22/2020,404,41042,15,0,0,0,0,0,356,10,10,0,2,1899,41446,1901,0,0
2,5/23/2020,408,41943,10,0,0,0,0,0,358,10,10,0,4,901,42351,905,0,0
2,5/24/2020,408,43099,10,0,0,0,0,0,358,10,10,0,0,1156,43507,1156,0,0
2,5/25/2020,409,44063,10,0,0,0,0,0,361,10,10,0,1,964,44472,965,0,0
2,5/26/2020,411,44553,12,0,0,0,0,0,362,10,10,0,2,490,44964,492,0,0
2,5/27/2020,412,45951,14,0,0,0,0,0,364,10,10,0,1,1398,46363,1399,0,0
2,5/28/2020,425,47545,10,0,0,0,0,0,366,10,10,0,13,1594,47970,1607,0,0
2,5/29/2020,430,49009,14,0,0,0,1,0,367,10,10,0,5,1464,49439,1469,0,0
2,5/30/2020,434,51261,14,0,0,0,2,0,368,10,10,0,4,2252,51695,2256,0,0
2,5/31/2020,434,51261,14,0,0,0,2,0,368,10,10,0,0,0,51695,0,0,0
2,6/1/2020,467,53723,10,0,0,0,1,0,368,10,10,0,33,2462,54190,2495,0,0
2,6/2/2020,487,55716,10,0,0,0,0,0,371,10,10,0,20,1993,56203,2013,0,0
2,6/3/2020,505,57677,11,0,0,0,0,0,373,10,10,0,18,1961,58182,1979,0,0
2,6/4/2020,513,59584,13,0,0,0,1,0,376,10,10,0,8,1907,60097,1915,0,0
2,6/5/2020,524,60466,8,0,0,0,1,0,380,10,10,0,11,882,60990,893,0,0
2,6/6/2020,536,63365,7,48,0,0,1,0,382,10,10,0,12,2899,63901,2911,0,48
2,6/7/2020,544,64360,7,0,0,0,1,0,382,10,10,0,8,995,64904,1003,0,-48
2,6/8/2020,563,65349,7,0,0,0,0,0,384,10,10,0,19,989,65912,1008,0,0
2,6/9/2020,573,66317,12,0,0,0,1,0,389,11,11,0,10,968,66890,978,1,0
2,6/10/2020,593,67127,22,0,0,0,3,0,392,11,11,0,20,810,67720,830,0,0
2,6/11/2020,611,68400,18,0,0,0,4,0,397,11,11,0,18,1273,69011,1291,0,0
2,6/12/2020,625,70255,15,0,0,0,3,0,403,12,12,0,14,1855,70880,1869,1,0
2,6/13/2020,654,71149,12,0,0,0,2,0,405,12,12,0,29,894,71803,923,0,0
2,6/14/2020,661,72806,11,0,0,0,1,0,411,12,12,0,7,1657,73467,1664,0,0
2,6/15/2020,664,73773,21,0,0,0,3,0,417,12,12,0,3,967,74437,970,0,0
2,6/16/2020,676,75539,22,0,0,0,2,0,429,12,12,0,12,1766,76215,1778,0,0
2,6/17/2020,696,77013,23,0,0,0,0,0,438,12,12,0,20,1474,77709,1494,0,0
2,6/18/2020,708,80477,18,0,0,0,0,0,449,12,12,0,12,3464,81185,3476,0,0
2,6/19/2020,722,82909,18,0,0,0,1,0,457,12,12,0,14,2432,83631,2446,0,0
2,6/20/2020,743,86175,16,0,0,0,1,0,464,12,12,0,21,3266,86918,3287,0,0
2,6/21/2020,755,87296,15,0,0,0,1,0,475,12,12,0,12,1121,88051,1133,0,0
2,6/22/2020,761,90063,13,0,0,0,1,0,491,12,12,0,6,2767,90824,2773,0,0
2,6/23/2020,778,92169,14,0,0,0,1,0,502,12,12,0,17,2106,92947,2123,0,0
2,6/24/2020,792,95304,16,0,0,0,2,0,507,12,12,0,14,3135,96096,3149,0,0
2,6/25/2020,816,98636,14,0,0,0,2,0,513,12,12,0,24,3332,99452,3356,0,0
2,6/26/2020,836,100956,12,0,0,0,2,0,519,14,14,0,20,2320,101792,2340,2,0
2,6/27/2020,854,104727,11,0,0,0,1,0,521,14,14,0,18,3771,105581,3789,0,0
2,6/28/2020,883,107417,12,0,0,0,1,0,521,14,14,0,29,2690,108300,2719,0,0
2,6/29/2020,904,107805,16,0,0,0,1,0,525,14,14,0,21,388,108709,409,0,0
2,6/30/2020,940,111245,18,0,0,0,1,0,526,14,14,0,36,3440,112185,3476,0,0
2,7/1/2020,978,113422,20,0,0,0,2,0,528,14,14,0,38,2177,114400,2215,0,0
2,7/2/2020,1017,114892,18,0,0,0,1,0,535,14,14,0,39,1470,115909,1509,0,0
2,7/3/2020,1063,119145,25,0,0,0,3,0,539,15,15,0,46,4253,120208,4299,1,0
2,7/4/2020,1111,121621,23,0,0,0,3,0,544,16,16,0,48,2476,122732,2524,1,0
2,7/5/2020,1138,122615,19,0,0,0,3,0,548,16,16,0,27,994,123753,1021,0,0
2,7/6/2020,1138,122615,19,0,0,0,3,0,548,16,16,0,0,0,123753,0,0,0
2,7/7/2020,1184,130236,25,0,0,0,1,0,560,17,17,0,46,7621,131420,7667,1,0
2,7/8/2020,1226,132175,30,0,0,0,0,0,563,17,17,0,42,1939,133401,1981,0,0
2,7/9/2020,1272,134472,28,0,0,0,0,0,571,17,17,0,46,2297,135744,2343,0,0
2,7/10/2020,1323,140608,30,0,0,0,0,0,588,17,17,0,51,6136,141931,6187,0,0
2,7/11/2020,1385,141991,31,0,0,0,1,0,598,17,17,0,62,1383,143376,1445,0,0
2,7/12/2020,1479,143996,27,0,0,0,0,0,615,17,17,0,94,2005,145475,2099,0,0
2,7/13/2020,1539,145051,22,0,0,0,0,0,620,17,17,0,60,1055,146590,1115,0,0
2,7/14/2020,1579,147894,25,0,0,0,1,0,642,17,17,0,40,2843,149473,2883,0,0
2,7/15/2020,1631,154462,32,0,0,0,0,0,669,17,17,0,52,6568,156093,6620,0,0
2,7/16/2020,2032,160990,32,0,0,0,0,0,688,17,17,0,401,6528,163022,6929,0,0
2,7/17/2020,2081,163333,32,0,0,0,0,0,697,17,17,0,49,2343,165414,2392,0,0
4,3/4/2020,2,27,0,4,0,0,0,0,0,0,0,0,0,0,29,0,0,0
4,3/5/2020,2,28,0,5,0,0,0,0,0,0,0,0,0,1,30,1,0,1
4,3/6/2020,3,33,0,6,0,0,0,0,0,0,0,0,1,5,36,6,0,1
4,3/7/2020,5,44,0,6,0,0,0,0,0,0,0,0,2,11,49,13,0,0
4,3/8/2020,5,44,0,6,0,0,0,0,0,0,0,0,0,0,49,0,0,0
4,3/9/2020,5,44,0,8,0,0,0,0,0,0,0,0,0,0,49,0,0,2
4,3/10/2020,6,51,0,8,0,0,0,0,0,0,0,0,1,7,57,8,0,0
4,3/11/2020,9,59,0,11,0,0,0,0,0,0,0,0,3,8,68,11,0,3
4,3/12/2020,9,82,0,16,0,0,0,0,0,0,0,0,0,23,91,23,0,5
4,3/13/2020,9,94,0,22,0,0,0,0,0,0,0,0,0,12,103,12,0,6
4,3/14/2020,12,121,0,26,0,0,0,0,0,0,0,0,3,27,133,30,0,4
4,3/15/2020,12,121,0,36,0,0,0,0,0,0,0,0,0,0,133,0,0,10
4,3/16/2020,18,125,0,42,0,0,0,0,0,0,0,0,6,4,143,10,0,6
4,3/17/2020,20,142,0,55,0,0,0,0,0,0,0,0,2,17,162,19,0,13
4,3/18/2020,28,148,0,67,0,0,0,0,0,0,0,0,8,6,176,14,0,12
4,3/19/2020,44,175,0,85,0,0,0,0,0,0,0,0,16,27,219,43,0,18
4,3/20/2020,65,211,0,108,0,0,0,0,0,0,0,0,21,36,276,57,0,23
4,3/21/2020,104,240,0,128,0,0,0,0,0,1,0,0,39,29,344,68,1,20
4,3/22/2020,152,282,0,145,0,0,0,0,0,2,0,0,48,42,434,90,1,17
4,3/23/2020,265,309,0,189,0,0,0,0,0,2,0,0,113,27,574,140,0,44
4,3/24/2020,357,313,0,219,0,0,0,0,0,5,0,0,92,4,670,96,3,30
4,3/25/2020,450,323,0,264,0,0,0,0,0,6,0,0,93,10,773,103,1,45
4,3/26/2020,577,347,0,303,0,0,0,0,0,8,0,0,127,24,924,151,2,39
4,3/27/2020,736,7455,0,343,0,0,0,0,0,13,0,0,159,7108,8191,7267,5,40
4,3/28/2020,873,7455,0,386,0,0,0,0,0,15,0,0,137,0,8328,137,2,43
4,3/29/2020,919,12953,0,427,0,0,0,0,0,17,0,0,46,5498,13872,5544,2,41
4,3/30/2020,1157,15602,0,478,0,0,0,0,0,20,0,0,238,2649,16759,2887,3,51
4,3/31/2020,1289,18082,0,534,0,0,0,0,0,24,0,0,132,2480,19371,2612,4,56
4,4/1/2020,1413,19645,0,582,0,0,0,0,0,29,0,0,124,1563,21058,1687,5,48
4,4/2/2020,1598,21111,0,616,0,0,0,0,0,32,0,0,185,1466,22709,1651,3,34
4,4/3/2020,1769,22904,0,667,0,0,0,0,0,41,0,0,171,1793,24673,1964,9,51
4,4/4/2020,2019,25141,0,711,0,0,0,0,0,52,0,0,250,2237,27160,2487,11,44
4,4/5/2020,2269,25141,0,760,0,0,0,0,0,64,0,0,250,0,27410,250,12,49
4,4/6/2020,2456,30078,0,819,0,0,0,0,0,65,0,0,187,4937,32534,5124,1,59
4,4/7/2020,2575,30800,0,853,0,0,0,0,0,73,0,0,119,722,33375,841,8,34
4,4/8/2020,2726,31838,0,906,0,0,0,0,0,80,0,0,151,1038,34564,1189,7,53
4,4/9/2020,3018,34160,0,950,0,0,0,0,0,89,0,0,292,2322,37178,2614,9,44
4,4/10/2020,3112,34622,0,995,0,0,0,0,0,97,0,0,94,462,37734,556,8,45
4,4/11/2020,3393,37137,0,1037,0,0,0,0,0,108,0,0,281,2515,40530,2796,11,42
4,4/12/2020,3539,38570,0,1074,0,0,0,0,0,115,0,0,146,1433,42109,1579,7,37
4,4/13/2020,3702,39645,525,1122,286,0,195,0,0,122,0,0,163,1075,43347,1238,7,48
4,4/14/2020,3806,40290,580,1171,286,0,216,0,249,131,0,0,104,645,44096,749,9,49
4,4/15/2020,3962,41348,590,1213,286,0,202,0,385,142,0,0,156,1058,45310,1214,11,42
4,4/16/2020,4234,43164,578,1258,278,0,188,0,460,150,0,0,272,1816,47398,2088,8,45
4,4/17/2020,4507,44723,566,1289,285,0,178,0,539,169,0,0,273,1559,49230,1832,19,31
4,4/18/2020,4719,46326,566,1341,285,0,178,0,539,177,0,0,212,1603,51045,1815,8,52
4,4/19/2020,4929,48061,631,1387,283,0,187,0,994,184,0,0,210,1735,52990,1945,7,46
4,4/20/2020,5064,49436,637,1454,285,0,181,0,1155,187,0,0,135,1375,54500,1510,3,67
4,4/21/2020,5251,49901,637,1484,285,0,181,0,1155,208,0,0,187,465,55152,652,21,30
4,4/22/2020,5459,51142,664,1528,300,0,195,0,1265,229,0,0,208,1241,56601,1449,21,44
4,4/23/2020,5769,52928,699,1572,305,0,201,0,1282,249,0,0,310,1786,58697,2096,20,44
4,4/24/2020,6045,54669,639,1626,332,0,186,0,1313,266,0,0,276,1741,60714,2017,17,54
4,4/25/2020,6280,56228,697,1672,313,0,191,0,1345,266,0,0,235,1559,62508,1794,0,46
4,4/26/2020,6526,58285,671,1716,308,0,200,0,1383,275,0,0,246,2057,64811,2303,9,44
4,4/27/2020,6716,59827,647,1772,328,0,200,0,1418,275,0,0,190,1542,66543,1732,0,56
4,4/28/2020,6948,60490,737,1824,303,0,193,0,1450,293,0,0,232,663,67438,895,18,52
4,4/29/2020,7202,61611,756,1884,312,0,191,0,1475,304,0,0,254,1121,68813,1375,11,60
4,4/30/2020,7648,64138,755,1937,311,0,194,0,1499,320,0,0,446,2527,71786,2973,16,53
4,5/1/2020,7962,66917,709,1986,311,0,187,0,1528,330,0,0,314,2779,74879,3093,10,49
4,5/2/2020,8364,69633,718,2033,291,0,198,0,1565,348,0,0,402,2716,77997,3118,18,47
4,5/3/2020,8640,72479,732,2089,282,0,192,0,1597,362,0,0,276,2846,81119,3122,14,56
4,5/4/2020,8919,76334,703,2135,288,0,200,0,1632,362,0,0,279,3855,85253,4134,0,46
4,5/5/2020,9305,78955,728,2192,303,0,185,0,1671,395,0,0,386,2621,88260,3007,33,57
4,5/6/2020,9707,82030,754,2244,286,0,193,0,1693,426,0,0,402,3075,91737,3477,31,52
4,5/7/2020,9945,86489,766,2292,288,0,196,0,1722,450,0,0,238,4459,96434,4697,24,48
4,5/8/2020,10526,90599,730,2350,295,0,197,0,1747,517,0,0,581,4110,101125,4691,67,58
4,5/9/2020,10960,94850,739,2386,296,0,186,0,2684,532,0,0,434,4251,105810,4685,15,36
4,5/10/2020,11119,99258,713,2421,300,0,195,0,2775,536,0,0,159,4408,110377,4567,4,35
4,5/11/2020,11380,105084,717,2462,297,0,201,0,2852,542,0,0,261,5826,116464,6087,6,41
4,5/12/2020,11736,111106,765,2504,318,0,204,0,2909,562,0,0,356,6022,122842,6378,20,42
4,5/13/2020,12176,115574,755,2543,292,0,191,0,2979,594,0,0,440,4468,127750,4908,32,39
4,5/14/2020,12674,121664,781,2595,323,0,201,0,3074,624,0,0,498,6090,134338,6588,30,52
4,5/15/2020,13169,128832,808,2636,313,0,222,0,3145,651,0,0,495,7168,142001,7663,27,41
4,5/16/2020,13631,133157,791,2673,344,0,210,0,3357,679,0,0,462,4325,146788,4787,28,37
4,5/17/2020,13937,137824,796,2703,337,0,201,0,3450,680,0,0,306,4667,151761,4973,1,30
4,5/18/2020,14170,142303,820,2757,329,0,200,0,3570,686,0,0,233,4479,156473,4712,6,54
4,5/19/2020,14566,147005,792,2800,318,0,201,0,3693,704,0,0,396,4702,161571,5098,18,43
4,5/20/2020,14897,150538,810,2836,298,0,208,0,3773,747,0,0,331,3533,165435,3864,43,36
4,5/21/2020,15315,156312,812,2885,299,0,197,0,3872,763,0,0,418,5774,171627,6192,16,49
4,5/22/2020,15608,160395,796,2943,311,0,203,0,3949,775,0,0,293,4083,176003,4376,12,58
4,5/23/2020,16039,164400,784,2984,309,0,193,0,4033,799,0,0,431,4005,180439,4436,24,41
4,5/24/2020,16339,167302,804,3026,322,0,201,0,4132,800,0,0,300,2902,183641,3202,1,42
4,5/25/2020,16561,171221,833,3077,334,0,212,0,4204,806,0,0,222,3919,187782,4141,6,51
4,5/26/2020,16783,173948,818,3122,336,0,208,0,4297,807,0,0,222,2727,190731,2949,1,45
4,5/27/2020,17262,179004,911,3172,375,0,237,0,4361,831,0,0,479,5056,196266,5535,24,50
4,5/28/2020,17763,185151,945,3223,374,0,222,0,4452,857,0,0,501,6147,202914,6648,26,51
4,5/29/2020,18465,191348,931,3281,378,0,238,0,4551,885,0,0,702,6197,209813,6899,28,58
4,5/30/2020,19255,197792,975,3334,386,0,241,0,4657,903,0,0,790,6444,217047,7234,18,53
4,5/31/2020,19936,205270,973,3379,376,0,239,0,4761,906,0,0,681,7478,225206,8159,3,45
4,6/1/2020,20123,207947,968,3445,377,0,238,0,4869,917,0,0,187,2677,228070,2864,11,66
4,6/2/2020,21250,216583,1009,3520,380,0,235,0,4967,941,0,0,1127,8636,237833,9763,24,75
4,6/3/2020,22233,222292,1092,3589,379,0,239,0,5076,981,0,0,983,5709,244525,6692,40,69
4,6/4/2020,22753,227002,1079,3642,375,0,223,0,5172,996,0,0,520,4710,249755,5230,15,53
4,6/5/2020,24332,239533,1234,3712,375,0,241,0,5298,1012,0,0,1579,12531,263865,14110,16,70
4,6/6/2020,25451,246195,1278,3777,391,0,292,0,5399,1042,0,0,1119,6662,271646,7781,30,65
4,6/7/2020,26889,254732,1252,3847,392,0,248,0,5517,1044,0,0,1438,8537,281621,9975,2,70
4,6/8/2020,27678,260403,1266,3911,390,0,246,0,5639,1047,0,0,789,5671,288081,6460,3,64
4,6/9/2020,28296,264917,1243,3959,438,0,264,0,5764,1070,0,0,618,4514,293213,5132,23,48
4,6/10/2020,29852,269835,1274,4000,413,0,273,0,5851,1095,0,0,1556,4918,299687,6474,25,41
4,6/11/2020,31264,278318,1291,4041,429,0,278,0,5980,1127,1060,67,1412,8483,309582,9895,32,41
4,6/12/2020,32918,289861,1336,4079,429,0,278,0,5980,1144,1060,67,1654,11543,322779,13197,17,38
4,6/13/2020,34458,293939,1412,4115,447,0,309,0,6209,1183,1116,67,1540,4078,328397,5618,39,36
4,6/14/2020,35691,302354,1457,4148,452,0,317,0,6333,1186,1119,67,1233,8415,338045,9648,3,33
4,6/15/2020,36705,308552,1449,4182,464,0,307,0,6462,1194,1127,67,1014,6198,345257,7212,8,34
4,6/16/2020,39097,315237,1506,4209,502,0,340,0,6598,1219,1140,79,2392,6685,354334,9077,25,27
4,6/17/2020,40924,325269,1582,4224,531,0,346,0,6715,1239,1159,80,1827,10032,366193,11859,20,15
4,6/18/2020,43443,336289,1667,4241,540,0,341,0,6863,1271,1184,87,2519,11020,379732,13539,32,17
4,6/19/2020,46689,345527,1832,4246,519,0,362,0,7018,1312,1224,88,3246,9238,392216,12484,41,5
4,6/20/2020,49798,355482,1938,4252,546,0,368,0,7196,1338,1247,91,3109,9955,405280,13064,26,6
4,6/21/2020,52390,367354,1942,4255,556,0,361,0,7387,1339,1248,91,2592,11872,419744,14464,1,3
4,6/22/2020,54586,375204,1992,4255,583,0,379,0,7581,1342,1251,91,2196,7850,429790,10046,3,0
4,6/23/2020,58179,382339,2136,4255,614,0,386,0,7746,1384,1291,93,3593,7135,440518,10728,42,0
4,6/24/2020,59974,389214,2270,4313,581,0,407,0,7936,1463,1366,97,1795,6875,449188,8670,79,58
4,6/25/2020,63030,401166,2453,4406,611,0,415,0,8139,1490,1393,97,3056,11952,464196,15008,27,93
4,6/26/2020,66548,413275,2110,4514,581,0,312,0,8389,1535,1435,100,3518,12109,479823,15627,45,108
4,6/27/2020,70051,424696,2577,4595,657,0,433,0,8659,1579,1479,100,3503,11421,494747,14924,44,81
4,6/28/2020,73908,435988,2691,4617,666,0,475,0,8926,1588,1488,100,3857,11292,509896,15149,9,22
4,6/29/2020,74533,436890,2721,4634,679,0,465,0,9179,1588,1488,100,625,902,511423,1527,0,17
4,6/30/2020,79215,453141,2793,4736,683,0,455,0,9411,1632,1529,103,4682,16251,532356,20933,44,102
4,7/1/2020,84092,465504,2876,4837,675,0,466,0,9715,1720,1607,113,4877,12363,549596,17240,88,101
4,7/2/2020,87425,473414,2938,4916,723,0,488,0,10137,1757,1642,115,3333,7910,560839,11243,37,79
4,7/3/2020,91858,486523,3013,5018,741,0,489,0,10478,1788,1673,115,4433,13109,578381,17542,31,102
4,7/4/2020,94553,494955,3113,5068,796,0,413,0,10903,1805,1690,115,2695,8432,589508,11127,17,50
4,7/5/2020,98089,506273,3182,5161,821,0,531,0,11361,1809,1694,115,3536,11318,604362,14854,4,93
4,7/6/2020,101441,516400,3212,5188,839,0,533,0,11836,1810,1695,115,3352,10127,617841,13479,1,27
4,7/7/2020,105094,523703,3356,5272,869,0,544,0,12260,1927,1807,120,3653,7303,628797,10956,117,84
4,7/8/2020,108614,532456,3421,5387,871,0,570,0,12803,1963,1842,121,3520,8753,641070,12273,36,115
4,7/9/2020,112671,540390,3437,5526,861,0,575,0,13341,2038,1917,121,4057,7934,653061,11991,75,139
4,7/10/2020,116892,552319,3432,5659,876,0,615,0,13853,2082,1961,121,4221,11929,669211,16150,44,133
4,7/11/2020,119930,564060,3485,5750,899,0,620,0,14394,2151,2030,121,3038,11741,683990,14779,69,91
4,7/12/2020,122467,573705,3432,5795,922,0,631,0,14829,2237,2114,123,2537,9645,696172,12182,86,45
4,7/13/2020,123824,578602,3373,5839,936,0,671,0,15254,2245,2122,123,1357,4897,702426,6254,8,44
4,7/14/2020,128097,593846,3517,5942,970,0,674,0,15678,2337,2208,129,4273,15244,721943,19517,92,103
4,7/15/2020,131354,604608,3493,6103,929,0,671,0,16155,2434,2295,139,3257,10762,735962,14019,97,161
4,7/16/2020,134613,614653,3454,6296,918,0,657,0,16684,2492,2353,139,3259,10045,749266,13304,58,193
4,7/17/2020,138523,626445,3466,6402,944,0,687,0,17184,2583,2431,152,3910,11792,764968,15702,91,106
5,3/6/2020,0,6,0,0,0,0,0,0,0,0,0,0,0,0,6,0,0,0
5,3/7/2020,0,6,0,0,0,0,0,0,0,0,0,0,0,0,6,0,0,0
5,3/8/2020,0,6,0,0,0,0,0,0,0,0,0,0,0,0,6,0,0,0
5,3/9/2020,0,12,0,0,0,0,0,0,0,0,0,0,0,6,12,6,0,0
5,3/10/2020,0,12,0,0,0,0,0,0,0,0,0,0,0,0,12,0,0,0
5,3/11/2020,0,12,0,0,0,0,0,0,0,0,0,0,0,0,12,0,0,0
5,3/12/2020,6,24,0,0,0,0,0,0,0,0,0,0,6,12,30,18,0,0
5,3/13/2020,9,30,0,0,0,0,0,0,0,0,0,0,3,6,39,9,0,0
5,3/14/2020,12,65,0,0,0,0,0,0,0,0,0,0,3,35,77,38,0,0
5,3/15/2020,16,103,0,0,0,0,0,0,0,0,0,0,4,38,119,42,0,0
5,3/16/2020,22,132,0,0,0,0,0,0,0,0,0,0,6,29,154,35,0,0
5,3/17/2020,22,197,0,0,0,0,0,0,0,0,0,0,0,65,219,65,0,0
5,3/18/2020,33,236,0,0,0,0,0,0,0,0,0,0,11,39,269,50,0,0
5,3/19/2020,46,310,0,0,0,0,0,0,0,0,0,0,13,74,356,87,0,0
5,3/20/2020,96,351,0,0,0,0,0,0,0,0,0,0,50,41,447,91,0,0
5,3/21/2020,118,567,0,0,0,0,0,0,0,0,0,0,22,216,685,238,0,0
5,3/22/2020,165,711,13,0,0,0,0,0,0,0,0,0,47,144,876,191,0,0
5,3/23/2020,174,906,13,0,0,0,0,0,0,0,0,0,9,195,1080,204,0,0
5,3/24/2020,218,947,22,0,0,0,0,0,0,0,0,0,44,41,1165,85,0,0
5,3/25/2020,280,1437,22,0,0,0,4,0,11,2,0,0,62,490,1717,552,2,0
5,3/26/2020,335,1504,41,0,0,0,13,0,13,3,0,0,55,67,1839,122,1,0
5,3/27/2020,381,1545,48,0,0,0,17,0,19,3,0,0,46,41,1926,87,0,0
5,3/28/2020,404,2938,48,0,0,0,17,0,24,5,0,0,23,1393,3342,1416,2,0
5,3/29/2020,426,3027,43,0,0,0,16,0,28,6,0,0,22,89,3453,111,1,0
5,3/30/2020,473,5262,62,0,0,0,21,0,29,7,0,0,47,2235,5735,2282,1,0
5,3/31/2020,523,5959,64,0,0,0,23,0,35,8,0,0,50,697,6482,747,1,0
5,4/1/2020,584,7354,56,90,0,0,25,32,42,10,0,0,61,1395,7938,1456,2,90
5,4/2/2020,643,7880,66,100,0,0,23,32,47,12,0,0,59,526,8523,585,2,10
5,4/3/2020,704,8995,71,105,0,0,26,39,60,12,0,0,61,1115,9699,1176,0,5
5,4/4/2020,743,9627,72,106,0,0,23,39,79,14,0,0,39,632,10370,671,2,1
5,4/5/2020,830,10412,67,130,0,0,27,39,97,16,0,0,87,785,11242,872,2,24
5,4/6/2020,875,11970,74,137,0,0,22,39,102,16,0,0,45,1558,12845,1603,0,7
5,4/7/2020,946,12692,74,148,0,0,26,43,142,16,0,0,71,722,13638,793,0,11
5,4/8/2020,1000,13530,76,130,0,43,30,39,208,18,0,0,54,838,14530,892,2,-18
5,4/9/2020,1119,13832,73,130,0,43,31,39,288,21,0,0,119,302,14951,421,3,0
5,4/10/2020,1171,15949,86,130,0,43,33,39,312,23,0,0,52,2117,17120,2169,2,0
5,4/11/2020,1226,17352,86,130,0,43,33,39,340,24,0,0,55,1403,18578,1458,1,0
5,4/12/2020,1280,18442,74,130,0,43,30,39,367,27,0,0,54,1090,19722,1144,3,0
5,4/13/2020,1410,19394,74,130,0,43,28,39,391,30,0,0,130,952,20804,1082,3,0
5,4/14/2020,1480,19651,81,130,0,43,29,39,427,30,0,0,70,257,21131,327,0,0
5,4/15/2020,1569,20265,83,130,0,43,26,39,489,33,0,0,89,614,21834,703,3,0
5,4/16/2020,1620,21055,85,0,0,0,21,0,548,37,0,0,51,790,22675,841,4,-130
5,4/17/2020,1695,21799,83,0,0,0,21,0,593,37,0,0,75,744,23494,819,0,0
5,4/18/2020,1739,22402,86,291,0,0,22,57,703,38,0,0,44,603,24141,647,1,291
5,4/19/2020,1781,22428,88,291,0,0,25,57,721,40,0,0,42,26,24209,68,2,0
5,4/20/2020,1923,24630,93,291,0,0,24,57,749,42,0,0,142,2202,26553,2344,2,0
5,4/21/2020,2227,25214,86,291,0,0,27,57,809,43,0,0,304,584,27441,888,1,0
5,4/22/2020,2276,27437,97,291,0,0,23,57,863,42,0,0,49,2223,29713,2272,-1,0
5,4/23/2020,2465,29125,101,291,0,0,24,57,902,45,0,0,189,1688,31590,1877,3,0
5,4/24/2020,2741,32837,101,291,0,0,24,57,929,45,0,0,276,3712,35578,3988,0,0
5,4/25/2020,2829,35224,104,291,0,0,25,57,964,47,0,0,88,2387,38053,2475,2,0
5,4/26/2020,2941,36528,104,291,0,0,25,57,985,49,0,0,112,1304,39469,1416,2,0
5,4/27/2020,3017,37440,109,0,0,0,25,0,987,50,0,0,76,912,40457,988,1,-291
5,4/28/2020,3111,37560,104,0,0,0,20,0,1146,52,0,0,94,120,40671,214,2,0
5,4/29/2020,3192,42257,93,389,0,0,18,82,1249,59,0,0,81,4697,45449,4778,7,389
5,4/30/2020,3255,45124,95,402,0,0,23,85,1305,61,0,0,63,2867,48379,2930,2,13
5,5/1/2020,3321,46355,95,414,0,0,23,85,1973,64,0,0,66,1231,49676,1297,3,12
5,5/2/2020,3372,48210,95,414,0,0,20,85,1987,73,0,0,51,1855,51582,1906,9,0
5,5/3/2020,3431,49459,100,427,0,0,20,88,1999,76,0,0,59,1249,52890,1308,3,13
5,5/4/2020,3458,50984,91,438,0,0,16,88,2016,81,0,0,27,1525,54442,1552,5,11
5,5/5/2020,3496,51139,89,453,0,0,16,89,2041,83,0,0,38,155,54635,193,2,15
5,5/6/2020,3568,55435,69,453,0,0,14,89,2109,85,0,0,72,4296,59003,4368,2,0
5,5/7/2020,3611,56384,69,462,0,0,14,93,2123,87,0,0,43,949,59995,992,2,9
5,5/8/2020,3694,60300,70,466,0,0,14,93,2159,88,0,0,83,3916,63994,3999,1,4
5,5/9/2020,3747,61781,64,471,0,0,14,96,2968,88,0,0,53,1481,65528,1534,0,5
5,5/10/2020,3747,61781,64,471,0,0,14,96,2968,88,0,0,0,0,65528,0,0,0
5,5/11/2020,4034,64996,61,480,0,0,11,98,3149,94,0,0,287,3215,69030,3502,6,9
5,5/12/2020,4164,66280,59,485,0,0,12,98,3220,95,0,0,130,1284,70444,1414,1,5
5,5/13/2020,4164,69051,59,497,0,0,12,99,3220,95,0,0,0,2771,73215,2771,0,12
5,5/14/2020,4236,71582,64,509,0,0,13,100,3277,97,0,0,72,2531,75818,2603,2,12
5,5/15/2020,4463,77066,65,520,0,0,9,101,3390,98,0,0,227,5484,81529,5711,1,11
5,5/16/2020,4578,77066,65,520,0,0,10,101,3472,98,0,0,115,0,81644,115,0,0
5,5/17/2020,4759,80426,65,520,0,0,9,101,3590,98,0,0,181,3360,85185,3541,0,0
5,5/18/2020,4813,80426,77,530,0,0,12,101,3645,100,0,0,54,0,85239,54,2,10
5,5/19/2020,4923,88778,78,535,0,0,14,101,3739,102,0,0,110,8352,93701,8462,2,5
5,5/20/2020,5003,91255,78,535,0,0,14,101,3852,107,0,0,80,2477,96258,2557,5,0
5,5/21/2020,5458,93818,78,535,0,0,14,101,3915,110,0,0,455,2563,99276,3018,3,0
5,5/22/2020,5612,97435,86,584,0,0,14,110,4029,113,0,0,154,3617,103047,3771,3,49
5,5/23/2020,5612,97435,81,590,0,0,14,111,4029,113,0,0,0,0,103047,0,0,6
5,5/24/2020,5922,102659,86,598,0,0,17,111,4148,116,0,0,310,5224,108581,5534,3,8
5,5/25/2020,6029,105593,92,605,0,0,17,111,4249,117,0,0,107,2934,111622,3041,1,7
5,5/26/2020,6180,105593,107,617,0,0,18,114,4332,119,0,0,151,0,111773,151,2,12
5,5/27/2020,6277,109319,108,627,0,0,22,116,4424,120,0,0,97,3726,115596,3823,1,10
5,5/28/2020,6538,112364,104,640,0,0,27,118,4583,120,0,0,261,3045,118902,3306,0,13
5,5/29/2020,6538,113230,104,667,0,0,27,119,4583,125,0,0,0,866,119768,866,5,27
5,5/30/2020,7013,119484,104,702,0,0,26,123,5166,133,0,0,475,6254,126497,6729,8,35
5,5/31/2020,7253,122262,115,711,0,0,27,123,5275,133,0,0,240,2778,129515,3018,0,9
5,6/1/2020,7443,125793,115,711,0,0,27,123,5401,133,0,0,190,3531,133236,3721,0,0
5,6/2/2020,7443,125793,121,718,0,0,26,124,5401,133,0,0,0,0,133236,0,0,7
5,6/3/2020,8067,134413,132,731,0,0,31,124,5717,142,0,0,624,8620,142480,9244,9,13
5,6/4/2020,8067,134413,138,757,0,0,30,127,5717,142,0,0,0,0,142480,0,0,26
5,6/5/2020,8651,138960,147,792,0,0,32,138,5919,152,0,0,584,4547,147611,5131,10,35
5,6/6/2020,9101,147656,154,838,0,0,36,142,6266,154,0,0,450,8696,156757,9146,2,46
5,6/7/2020,9426,150847,145,844,0,0,35,143,6424,154,0,0,325,3191,160273,3516,0,6
5,6/8/2020,9740,150847,171,844,0,0,46,143,6424,155,0,0,314,0,160587,314,1,0
5,6/9/2020,10080,155701,173,865,0,0,44,144,6875,161,0,0,340,4854,165781,5194,6,21
5,6/10/2020,10368,165849,181,901,0,0,49,147,7116,165,0,0,288,10148,176217,10436,4,36
5,6/11/2020,10816,165849,187,925,0,0,45,150,7351,171,0,0,448,0,176665,448,6,24
5,6/12/2020,11547,169575,203,961,0,0,49,157,7607,176,0,0,731,3726,181122,4457,5,36
5,6/13/2020,11547,175470,203,979,0,0,49,160,7607,176,0,0,0,5895,187017,5895,0,18
5,6/14/2020,12501,184488,204,998,0,0,46,162,8110,179,0,0,954,9018,196989,9972,3,19
5,6/15/2020,12917,191221,206,1003,0,0,45,163,8352,182,0,0,416,6733,204138,7149,3,5
5,6/16/2020,13191,192375,214,1026,0,0,45,165,8352,182,0,0,274,1154,205566,1428,0,23
5,6/17/2020,13606,207093,217,1052,0,0,53,168,8996,197,0,0,415,14718,220699,15133,15,26
5,6/18/2020,13928,214506,226,1074,0,0,53,173,9376,208,0,0,322,7413,228434,7735,11,22
5,6/19/2020,14631,220141,224,1100,0,0,53,175,9712,214,0,0,703,5635,234772,6338,6,26
5,6/20/2020,15142,227092,224,1100,0,0,53,175,10082,224,0,0,511,6951,242234,7462,10,0
5,6/21/2020,15142,227092,240,1152,0,0,59,184,10082,224,0,0,0,0,242234,0,0,52
5,6/22/2020,16083,240256,237,1164,0,0,61,186,10793,227,0,0,941,13164,256339,14105,3,12
5,6/23/2020,16678,247814,248,1188,0,0,57,186,11220,237,0,0,595,7558,264492,8153,10,24
5,6/24/2020,17375,254491,267,1214,0,0,58,189,11568,240,0,0,697,6677,271866,7374,3,26
5,6/25/2020,18062,259318,284,1245,0,0,61,194,12127,240,0,0,687,4827,277380,5514,0,31
5,6/26/2020,18062,259318,284,1300,0,0,61,203,12127,240,0,0,0,0,277380,0,0,55
5,6/27/2020,18740,265225,284,1337,0,0,63,206,12784,249,0,0,678,5907,283965,6585,9,37
5,6/28/2020,19310,271912,278,1373,0,0,63,210,13270,259,0,0,570,6687,291222,7257,10,36
5,6/29/2020,20257,282279,300,1380,0,0,63,211,14066,265,0,0,947,10367,302536,11314,6,7
5,6/30/2020,20777,290426,290,1413,0,0,67,220,14531,270,0,0,520,8147,311203,8667,5,33
5,7/1/2020,21197,293661,275,1448,0,0,72,224,15163,277,0,0,420,3235,314858,3655,7,35
5,7/2/2020,22075,301912,272,1477,0,0,72,231,15698,279,0,0,878,8251,323987,9129,2,29
5,7/3/2020,22622,308615,285,1517,0,0,70,236,16164,281,0,0,547,6703,331237,7250,2,40
5,7/4/2020,23209,315684,285,1536,0,0,70,240,16726,286,0,0,587,7069,338893,7656,5,19
5,7/5/2020,23209,315684,285,1536,0,0,70,240,16726,286,0,0,0,0,338893,0,0,0
5,7/6/2020,24253,320715,337,1575,0,0,81,245,17834,292,0,0,1044,5031,344968,6075,6,39
5,7/7/2020,24512,326143,369,1604,0,0,81,247,17834,292,0,0,259,5428,350655,5687,0,29
5,7/8/2020,24512,328760,358,1655,0,0,89,254,18725,301,0,0,0,2617,353272,2617,9,51
5,7/9/2020,26052,338609,394,1705,0,0,82,284,19992,309,0,0,1540,9849,364661,11389,8,50
5,7/10/2020,26803,338609,402,1743,0,0,84,260,20642,313,0,0,751,0,365412,751,4,38
5,7/11/2020,26803,342846,402,1780,0,0,84,265,20642,313,0,0,0,4237,369649,4237,0,37
5,7/12/2020,28367,354035,412,1822,0,0,84,266,21591,321,0,0,1564,11189,382402,12753,8,42
5,7/13/2020,28939,354035,439,1836,0,0,89,269,22106,323,0,0,572,0,382974,572,2,14
5,7/14/2020,29733,360566,445,1872,0,0,91,273,22844,331,0,0,794,6531,390299,7325,8,36
5,7/15/2020,30297,365479,458,1948,0,0,94,279,23523,335,0,0,564,4913,395776,5477,4,76
5,7/16/2020,31114,369847,470,1994,0,0,101,286,24195,341,0,0,817,4368,400961,5185,6,46
5,7/17/2020,31762,375735,464,2070,0,0,97,298,24776,353,0,0,648,5888,407497,6536,12,76
6,3/4/2020,53,462,0,0,0,0,0,0,0,0,0,0,0,0,515,0,0,0
6,3/5/2020,53,462,0,0,0,0,0,0,0,0,0,0,0,0,515,0,0,0
6,3/6/2020,60,462,0,0,0,0,0,0,0,0,0,0,7,0,522,7,0,0
6,3/7/2020,69,462,0,0,0,0,0,0,0,0,0,0,9,0,531,9,0,0
6,3/8/2020,88,462,0,0,0,0,0,0,0,0,0,0,19,0,550,19,0,0
6,3/9/2020,114,690,0,0,0,0,0,0,0,0,0,0,26,228,804,254,0,0
6,3/10/2020,133,690,0,0,0,0,0,0,0,0,0,0,19,0,823,19,0,0
6,3/11/2020,157,916,0,0,0,0,0,0,0,0,0,0,24,226,1073,250,0,0
6,3/12/2020,202,916,0,0,0,0,0,0,0,4,0,0,45,0,1118,45,4,0
6,3/13/2020,202,916,0,0,0,0,0,0,0,4,0,0,0,0,1118,0,0,0
6,3/14/2020,252,916,0,0,0,0,0,0,0,5,0,0,50,0,1168,50,1,0
6,3/15/2020,293,916,0,0,0,0,0,0,0,5,0,0,41,0,1209,41,0,0
6,3/16/2020,335,7981,0,0,0,0,0,0,0,6,0,0,42,7065,8316,7107,1,0
6,3/17/2020,483,7981,0,0,0,0,0,0,0,11,0,0,148,0,8464,148,5,0
6,3/18/2020,611,7981,0,0,0,0,0,0,0,13,0,0,128,0,8592,128,2,0
6,3/19/2020,924,8787,0,0,0,0,0,0,0,18,0,0,313,806,9711,1119,5,0
6,3/20/2020,1063,10424,0,0,0,0,0,0,0,20,0,0,139,1637,11487,1776,2,0
6,3/21/2020,1279,11249,0,0,0,0,0,0,0,24,0,0,216,825,12528,1041,4,0
6,3/22/2020,1536,11304,0,0,0,0,0,0,0,27,0,0,257,55,12840,312,3,0
6,3/23/2020,1733,12567,0,0,0,0,0,0,0,27,0,0,197,1263,14300,1460,0,0
6,3/24/2020,2102,13452,0,0,0,0,0,0,0,40,0,0,369,885,15554,1254,13,0
6,3/25/2020,2355,15921,0,0,0,0,0,0,0,53,0,0,253,2469,18276,2722,13,0
6,3/26/2020,3006,17380,0,0,0,0,0,0,0,65,0,0,651,1459,20386,2110,12,0
6,3/27/2020,3879,17380,746,0,200,0,0,0,0,78,0,0,873,0,21259,873,13,0
6,3/28/2020,4643,20549,1034,0,410,0,0,0,0,101,0,0,764,3169,25192,3933,23,0
6,3/29/2020,5708,20549,1034,0,410,0,0,0,0,123,0,0,1065,0,26257,1065,22,0
6,3/30/2020,6447,20549,1432,0,597,0,0,0,0,133,0,0,739,0,26996,739,10,0
6,3/31/2020,7482,21772,1617,0,657,0,0,0,0,153,0,0,1035,1223,29254,2258,20,0
6,4/1/2020,8155,21772,1855,0,774,0,0,0,0,171,0,0,673,0,29927,673,18,0
6,4/2/2020,9191,23809,1922,0,816,0,0,0,0,203,0,0,1036,2037,33000,3073,32,0
6,4/3/2020,10701,24599,2188,0,901,0,0,0,0,237,0,0,1510,790,35300,2300,34,0
6,4/4/2020,12026,101674,2300,0,1008,0,0,0,0,276,0,0,1325,77075,113700,78400,39,0
6,4/5/2020,13438,103095,2398,0,1040,0,0,0,0,319,0,0,1412,1421,116533,2833,43,0
6,4/6/2020,14336,103095,2509,0,1085,0,0,0,0,343,0,0,898,0,117431,898,24,0
6,4/7/2020,15865,115364,2611,0,1108,0,0,0,0,374,0,0,1529,12269,131229,13798,31,0
6,4/8/2020,16957,127307,2714,0,1154,0,0,0,0,442,0,0,1092,11943,144264,13035,68,0
6,4/9/2020,18309,145191,2825,0,1132,0,0,0,0,492,0,0,1352,17884,163500,19236,50,0
6,4/10/2020,19472,145391,2897,0,1145,0,0,0,0,541,0,0,1163,200,164863,1363,49,0
6,4/11/2020,20615,152604,5236,0,1591,0,0,0,0,609,0,0,1143,7213,173219,8356,68,0
6,4/12/2020,21794,168534,5234,0,1539,0,0,0,0,651,0,0,1179,15930,190328,17109,42,0
6,4/13/2020,22348,168534,3015,0,1178,0,0,0,0,687,0,0,554,0,190882,554,36,0
6,4/14/2020,23338,178870,5163,0,1552,0,0,0,0,758,0,0,990,10336,202208,11326,71,0
6,4/15/2020,24424,192062,5163,0,1175,0,0,0,0,821,0,0,1086,13192,216486,14278,63,0
6,4/16/2020,26182,220218,5031,0,1568,0,0,0,0,890,0,0,1758,28156,246400,29914,69,0
6,4/17/2020,27528,224086,4892,0,1484,0,0,0,0,985,0,0,1346,3868,251614,5214,95,0
6,4/18/2020,28963,230703,4936,0,1490,0,0,0,0,1072,0,0,1435,6617,259666,8052,87,0
6,4/19/2020,30333,250567,4731,0,1457,0,0,0,0,1166,0,0,1370,19864,280900,21234,94,0
6,4/20/2020,30978,259522,4674,0,1480,0,0,0,0,1208,0,0,645,8955,290500,9600,42,0
6,4/21/2020,33261,266839,4886,0,1502,0,0,0,0,1268,0,0,2283,7317,300100,9600,60,0
6,4/22/2020,35396,429931,4984,0,1551,0,0,0,0,1354,0,0,2135,163092,465327,165227,86,0
6,4/23/2020,37369,444728,4929,0,1531,0,0,0,0,1469,0,0,1973,14797,482097,16770,115,0
6,4/24/2020,39254,454919,4880,0,1521,0,0,0,0,1562,0,0,1885,10191,494173,12076,93,0
6,4/25/2020,41137,464898,4847,0,1458,0,0,0,0,1651,0,0,1883,9979,506035,11862,89,0
6,4/26/2020,42164,483920,4928,0,1473,0,0,0,0,1710,0,0,1027,19022,526084,20049,59,0
6,4/27/2020,43464,509945,4878,0,1499,0,0,0,0,1755,0,0,1300,26025,553409,27325,45,0
6,4/28/2020,45031,532577,4983,0,1485,0,0,0,0,1809,0,0,1567,22632,577608,24199,54,0
6,4/29/2020,46500,556639,5011,0,1512,0,0,0,0,1887,0,0,1469,24062,603139,25531,78,0
6,4/30/2020,48917,576420,4981,0,1473,0,0,0,0,1982,0,0,2417,19781,625337,22198,95,0
6,5/1/2020,50442,604543,4706,0,1434,0,0,0,0,2073,0,0,1525,28123,654985,29648,91,0
6,5/2/2020,52197,634606,4722,0,1433,0,0,0,0,2171,0,0,1755,30063,686803,31818,98,0
6,5/3/2020,53616,662135,4734,0,1468,0,0,0,0,2215,0,0,1419,27529,715751,28948,44,0
6,5/4/2020,54937,692937,4616,0,1464,0,0,0,0,2254,0,0,1321,30802,747874,32123,39,0
6,5/5/2020,56212,723690,4622,0,1388,0,0,0,0,2317,0,0,1275,30753,779902,32028,63,0
6,5/6/2020,58815,750221,4681,0,1415,0,0,0,0,2412,0,0,2603,26531,809036,29134,95,0
6,5/7/2020,60614,782260,4560,0,1374,0,0,0,0,2504,0,0,1799,32039,842874,33838,92,0
6,5/8/2020,62512,812760,4514,0,1342,0,0,0,0,2585,0,0,1898,30500,875272,32398,81,0
6,5/9/2020,64561,848009,4538,0,1349,0,0,0,0,2678,0,0,2049,35249,912570,37298,93,0
6,5/10/2020,66680,888984,4555,0,1328,0,0,0,0,2745,0,0,2119,40975,955664,43094,67,0
6,5/11/2020,67939,923958,4549,0,1329,0,0,0,0,2770,0,0,1259,34974,991897,36233,25,0
6,5/12/2020,69382,963988,4544,0,1349,0,0,0,0,2847,0,0,1443,40030,1033370,41473,77,0
6,5/13/2020,71141,994451,4545,0,1314,0,0,0,0,2934,0,0,1759,30463,1065592,32222,87,0
6,5/14/2020,73164,1031487,4655,0,1324,0,0,0,0,3032,0,0,2023,37036,1104651,39059,98,0
6,5/15/2020,74936,1058970,4519,0,1324,0,0,0,0,3108,0,0,1772,27483,1133906,29255,76,0
6,5/16/2020,76793,1102333,4424,0,1313,0,0,0,0,3204,0,0,1857,43363,1179126,45220,96,0
6,5/17/2020,78839,1156404,4291,0,1293,0,0,0,0,3261,0,0,2046,54071,1235243,56117,57,0
6,5/18/2020,80430,1212242,4391,0,1325,0,0,0,0,3302,0,0,1591,55838,1292672,57429,41,0
6,5/19/2020,81795,1257521,4363,0,1307,0,0,0,0,3334,0,0,1365,45279,1339316,46644,32,0
6,5/20/2020,84057,1296063,4681,0,1345,0,0,0,0,3436,0,0,2262,38542,1380120,40804,102,0
6,5/21/2020,86197,1334930,4735,0,1310,0,0,0,0,3542,0,0,2140,38867,1421127,41007,106,0
6,5/22/2020,88444,1378329,4762,0,1317,0,0,0,0,3630,0,0,2247,43399,1466773,45646,88,0
6,5/23/2020,90631,1424675,4342,0,1312,0,0,0,0,3708,0,0,2187,46346,1515306,48533,78,0
6,5/24/2020,92710,1490035,4300,0,1315,0,0,0,0,3774,0,0,2079,65360,1582745,67439,66,0
6,5/25/2020,94558,1549544,4306,0,1301,0,0,0,0,3795,0,0,1848,59509,1644102,61357,21,0
6,5/26/2020,96733,1599663,4404,0,1392,0,0,0,0,3814,0,0,2175,50119,1696396,52294,19,0
6,5/27/2020,98980,1637914,4544,0,1407,0,0,0,0,3884,0,0,2247,38251,1736894,40498,70,0
6,5/28/2020,101697,1688862,4529,0,1325,0,0,0,0,3973,0,0,2717,50948,1790559,53665,89,0
6,5/29/2020,103886,1731592,4414,0,1328,0,0,0,0,4068,0,0,2189,42730,1835478,44919,95,0
6,5/30/2020,106878,1781717,4215,0,1273,0,0,0,0,4156,0,0,2992,50125,1888595,53117,88,0
6,5/31/2020,110583,1834265,4331,0,1324,0,0,0,0,4213,0,0,3705,52548,1944848,56253,57,0
6,6/1/2020,113006,1899577,4258,0,1273,0,0,0,0,4251,0,0,2423,65312,2012583,67735,38,0
6,6/2/2020,115310,1956281,4393,0,1286,0,0,0,0,4286,0,0,2304,56704,2071591,59008,35,0
6,6/3/2020,117687,2013607,4458,0,1313,0,0,0,0,4361,0,0,2377,57326,2131294,59703,75,0
6,6/4/2020,119807,2062864,4455,0,1279,0,0,0,0,4422,0,0,2120,49257,2182671,51377,61,0
6,6/5/2020,122901,2115562,4625,0,1333,0,0,0,0,4485,0,0,3094,52698,2238463,55792,63,0
6,6/6/2020,126016,2182284,4526,0,1315,0,0,0,0,4559,0,0,3115,66722,2308300,69837,74,0
6,6/7/2020,128812,2233406,4525,0,1288,0,0,0,0,4626,0,0,2796,51122,2362218,53918,67,0
6,6/8/2020,131319,2299871,4506,0,1301,0,0,0,0,4653,0,0,2507,66465,2431190,68972,27,0
6,6/9/2020,133489,2352756,4583,0,1345,0,0,0,0,4697,0,0,2170,52885,2486245,55055,44,0
6,6/10/2020,136191,2404607,4719,0,1326,0,0,0,0,4776,0,0,2702,51851,2540798,54553,79,0
6,6/11/2020,139281,2458366,4534,0,1325,0,0,0,0,4881,0,0,3090,53759,2597647,56849,105,0
6,6/12/2020,141983,2520275,4480,0,1310,0,0,0,0,4943,0,0,2702,61909,2662258,64611,62,0
6,6/13/2020,145643,2578750,4411,0,1313,0,0,0,0,4989,0,0,3660,58475,2724393,62135,46,0
6,6/14/2020,148855,2653141,4247,0,1280,0,0,0,0,5063,0,0,3212,74391,2801996,77603,74,0
6,6/15/2020,151452,2716730,4323,0,1270,0,0,0,0,5089,0,0,2597,63589,2868182,66186,26,0
6,6/16/2020,153560,2784195,4462,0,1272,0,0,0,0,5121,0,0,2108,67465,2937755,69573,32,0
6,6/17/2020,157015,2840973,4522,0,1318,0,0,0,0,5208,0,0,3455,56778,2997988,60233,87,0
6,6/18/2020,161099,2913431,4584,0,1298,0,0,0,0,5290,0,0,4084,72458,3074530,76542,82,0
6,6/19/2020,165416,2990286,4587,0,1329,0,0,0,0,5360,0,0,4317,76855,3155702,81172,70,0
6,6/20/2020,169309,3065103,4582,0,1332,0,0,0,0,5424,0,0,3893,74817,3234412,78710,64,0
6,6/21/2020,173824,3145432,4679,0,1366,0,0,0,0,5495,0,0,4515,80329,3319256,84844,71,0
6,6/22/2020,178054,3233632,4804,0,1412,0,0,0,0,5515,0,0,4230,88200,3411686,92430,20,0
6,6/23/2020,183073,3313856,5065,0,1421,0,0,0,0,5580,0,0,5019,80224,3496929,85243,65,0
6,6/24/2020,190222,3402677,5399,0,1487,0,0,0,0,5632,0,0,7149,88821,3592899,95970,52,0
6,6/25/2020,195571,3498774,5522,0,1523,0,0,0,0,5733,0,0,5349,96097,3694345,101446,101,0
6,6/26/2020,200461,3570853,5639,0,1570,0,0,0,0,5812,0,0,4890,72079,3771314,76969,79,0
6,6/27/2020,206433,3655877,5790,0,1562,0,0,0,0,5872,0,0,5972,85024,3862310,90996,60,0
6,6/28/2020,211243,3744709,5956,0,1602,0,0,0,0,5905,0,0,4810,88832,3955952,93642,33,0
6,6/29/2020,219252,3842440,6179,0,1686,0,0,0,0,5936,0,0,8009,97731,4061692,105740,31,0
6,6/30/2020,228732,3938407,6466,0,1751,0,0,0,0,5980,0,0,9480,95967,4167139,105447,44,0
6,7/1/2020,236139,4018037,6612,0,1859,0,0,0,0,6090,0,0,7407,79630,4254176,87037,110,0
6,7/2/2020,242547,4096171,6812,0,1934,0,0,0,0,6163,0,0,6408,78134,4338718,84542,73,0
6,7/3/2020,248235,4199941,7024,0,1871,0,0,0,0,6263,0,0,5688,103770,4448176,109458,100,0
6,7/4/2020,257388,4295643,7092,0,1888,0,0,0,0,6313,0,0,9153,95702,4553031,104855,50,0
6,7/5/2020,265985,4414153,7149,0,1907,0,0,0,0,6331,0,0,8597,118510,4680138,127107,18,0
6,7/6/2020,271684,4521669,7278,0,1937,0,0,0,0,6337,0,0,5699,107516,4793353,113215,6,0
6,7/7/2020,277774,4618596,7499,0,1984,0,0,0,0,6448,0,0,6090,96927,4896370,103017,111,0
6,7/8/2020,289468,4706707,7705,0,1976,0,0,0,0,6562,0,0,11694,88111,4996175,99805,114,0
6,7/9/2020,296499,4781935,7821,0,1957,0,0,0,0,6711,0,0,7031,75228,5078434,82259,149,0
6,7/10/2020,304297,4871440,7896,0,2005,0,0,0,0,6851,0,0,7798,89505,5175737,97303,140,0
6,7/11/2020,312344,4963351,7904,0,2021,0,0,0,0,6945,0,0,8047,91911,5275695,99958,94,0
6,7/12/2020,320804,5085795,7854,0,2020,0,0,0,0,7017,0,0,8460,122444,5406599,130904,72,0
6,7/13/2020,329162,5215203,7895,0,2021,0,0,0,0,7040,0,0,8358,129408,5544365,137766,23,0
6,7/14/2020,336508,5338447,8145,0,2083,0,0,0,0,7087,0,0,7346,123244,5674955,130590,47,0
6,7/15/2020,347634,5445642,8353,0,2110,0,0,0,0,7227,0,0,11126,107195,5793276,118321,140,0
6,7/16/2020,356178,5559330,8363,0,2120,0,0,0,0,7345,0,0,8544,113688,5915508,122232,118,0
6,7/17/2020,366164,5677935,8450,0,2153,0,0,0,0,7475,0,0,9986,118605,6044099,128591,130,0
8,3/5/2020,0,19,0,0,0,0,0,0,0,0,0,0,0,0,19,0,0,0
8,3/6/2020,2,46,0,0,0,0,0,0,0,0,0,0,2,27,48,29,0,0
8,3/7/2020,8,55,0,0,0,0,0,0,0,0,0,0,6,9,63,15,0,0
8,3/8/2020,8,104,0,0,0,0,0,0,0,0,0,0,0,49,112,49,0,0
8,3/9/2020,9,133,0,0,0,0,0,0,0,0,0,0,1,29,142,30,0,0
8,3/10/2020,12,142,0,0,0,0,0,0,0,0,0,0,3,9,154,12,0,0
8,3/11/2020,28,251,0,0,0,0,0,0,0,0,0,0,16,109,279,125,0,0
8,3/12/2020,45,298,0,0,0,0,0,0,0,0,0,0,17,47,343,64,0,0
8,3/13/2020,72,524,0,0,0,0,0,0,0,0,0,0,27,226,596,253,0,0
8,3/14/2020,101,610,0,0,0,0,0,0,0,1,0,0,29,86,711,115,1,0
8,3/15/2020,131,627,0,0,0,0,0,0,0,1,0,0,30,17,758,47,0,0
8,3/16/2020,131,627,0,0,0,0,0,0,0,1,0,0,0,0,758,0,0,0
8,3/17/2020,160,1056,0,0,0,0,0,0,0,1,0,0,29,429,1216,458,0,0
8,3/18/2020,183,1617,0,0,0,0,0,0,0,2,0,0,23,561,1800,584,1,0
8,3/19/2020,216,2112,0,0,0,0,0,0,0,2,0,0,33,495,2328,528,0,0
8,3/20/2020,277,2675,0,0,0,0,0,0,0,3,0,0,61,563,2952,624,1,0
8,3/21/2020,363,3317,0,44,0,0,0,0,0,4,0,0,86,642,3680,728,1,44
8,3/22/2020,475,4075,56,49,0,0,0,0,0,5,0,0,112,758,4550,870,1,5
8,3/23/2020,591,4845,74,58,0,0,0,0,0,6,0,0,116,770,5436,886,1,9
8,3/24/2020,720,5504,116,72,0,0,0,0,0,7,0,0,129,659,6224,788,1,14
8,3/25/2020,912,6789,152,84,0,0,0,0,0,11,0,0,192,1285,7701,1477,4,12
8,3/26/2020,1086,6978,230,148,0,0,0,0,0,19,0,0,174,189,8064,363,8,64
8,3/27/2020,1430,8692,278,184,0,0,0,0,0,24,0,0,344,1714,10122,2058,5,36
8,3/28/2020,1734,9942,307,239,0,0,0,0,0,31,0,0,304,1250,11676,1554,7,55
8,3/29/2020,2061,11215,332,274,0,0,0,0,0,44,0,0,327,1273,13276,1600,13,35
8,3/30/2020,2627,12737,358,414,0,0,0,0,0,51,0,0,566,1522,15364,2088,7,140
8,3/31/2020,2627,12737,503,414,0,0,0,0,0,51,0,0,0,0,15364,0,0,0
8,4/1/2020,2966,13883,574,509,0,0,0,0,0,69,0,0,339,1146,16849,1485,18,95
8,4/2/2020,3342,15303,698,620,0,0,0,0,0,80,0,0,376,1420,18645,1796,11,111
8,4/3/2020,3728,16683,739,710,0,0,0,0,0,97,0,0,386,1380,20411,1766,17,90
8,4/4/2020,4173,17898,777,823,0,0,0,0,0,111,0,0,445,1215,22071,1660,14,113
8,4/5/2020,4565,19335,783,875,0,0,0,0,0,126,0,0,392,1437,23900,1829,15,52
8,4/6/2020,4950,20823,786,924,0,0,0,0,0,140,0,0,385,1488,25773,1873,14,49
8,4/7/2020,5172,21703,786,994,0,0,0,0,0,150,0,0,222,880,26875,1102,10,70
8,4/8/2020,5429,22665,833,1079,0,0,0,0,0,179,0,0,257,962,28094,1219,29,85
8,4/9/2020,5655,23544,848,1162,0,0,0,0,0,193,0,0,226,879,29199,1105,14,83
8,4/10/2020,6510,26143,842,1312,0,0,0,0,0,250,0,0,855,2599,32653,3454,57,150
8,4/11/2020,6510,26143,841,1312,0,0,0,0,0,250,0,0,0,0,32653,0,0,0
8,4/12/2020,6893,27980,822,1376,0,0,0,0,0,274,0,0,383,1837,34873,2220,24,64
8,4/13/2020,7684,29850,842,1472,0,0,0,0,0,304,0,0,791,1870,37534,2661,30,96
8,4/14/2020,7691,31051,888,1493,0,0,0,0,0,308,0,0,7,1201,38742,1208,4,21
8,4/15/2020,7941,31639,878,1556,0,0,0,0,0,329,0,0,250,588,39580,838,21,63
8,4/16/2020,8280,32253,859,1636,0,0,0,0,0,357,0,0,339,614,40533,953,28,80
8,4/17/2020,8675,33155,858,1693,0,0,0,0,0,374,0,0,395,902,41830,1297,17,57
8,4/18/2020,9047,34260,843,1755,0,0,0,0,0,391,0,0,372,1105,43307,1477,17,62
8,4/19/2020,9433,35173,874,1797,0,0,0,0,0,411,0,0,386,913,44606,1299,20,42
8,4/20/2020,9730,36465,874,1813,0,0,0,0,0,422,0,0,297,1292,46195,1589,11,16
8,4/21/2020,10106,37360,861,1880,0,0,0,0,0,449,0,0,376,895,47466,1271,27,67
8,4/22/2020,10447,38257,851,2003,0,0,0,0,0,486,0,0,341,897,48704,1238,37,123
8,4/23/2020,10878,39767,859,2123,0,0,0,0,0,508,0,0,431,1510,50645,1941,22,120
8,4/24/2020,11262,41062,1084,2237,0,0,0,0,0,552,0,0,384,1295,52324,1679,44,114
8,4/25/2020,12256,44533,1084,2366,0,0,0,0,2086,674,0,0,994,3471,56789,4465,122,129
8,4/26/2020,12968,46823,1046,2410,0,0,0,0,2150,672,0,0,712,2290,59791,3002,-2,44
8,4/27/2020,13441,49833,1007,2438,0,0,0,0,2150,680,0,0,473,3010,63274,3483,8,28
8,4/28/2020,13879,52462,994,2485,0,0,0,0,2275,706,0,0,438,2629,66341,3067,26,47
8,4/29/2020,14735,54714,964,2610,0,0,0,0,2275,760,0,0,856,2252,69449,3108,54,125
8,4/30/2020,14758,56301,966,2621,0,0,0,0,2415,766,0,0,23,1587,71059,1610,6,11
8,5/1/2020,15284,57106,959,2697,0,0,0,0,2486,777,0,0,526,805,72390,1331,11,76
8,5/2/2020,15768,61181,931,2747,0,0,0,0,2553,820,0,0,484,4075,76949,4559,43,50
8,5/3/2020,16225,63681,883,2793,0,0,0,0,2607,832,0,0,457,2500,79906,2957,12,46
8,5/4/2020,16635,66455,883,2799,0,0,0,0,2650,842,0,0,410,2774,83090,3184,10,6
8,5/5/2020,16907,68097,834,2838,0,0,0,0,2743,851,0,0,272,1642,85004,1914,9,39
8,5/6/2020,17364,68612,792,2919,0,0,0,0,2801,903,0,0,457,515,85976,972,52,81
8,5/7/2020,17830,73517,798,2986,0,0,0,0,2869,921,0,0,466,4905,91347,5371,18,67
8,5/8/2020,18801,75735,821,3557,0,0,0,0,2869,961,0,0,971,2218,94536,3189,40,571
8,5/9/2020,18827,77945,790,3600,0,0,0,0,2974,960,0,0,26,2210,96772,2236,-1,43
8,5/10/2020,19703,84374,790,3623,0,0,0,0,3023,967,0,0,876,6429,104077,7305,7,23
8,5/11/2020,19899,88891,573,3689,0,0,0,0,3076,981,0,0,196,4517,108790,4713,14,66
8,5/12/2020,19879,88778,738,3663,0,0,0,0,3114,987,0,0,-20,-113,108657,-133,6,-26
8,5/13/2020,20157,91093,688,3695,0,0,0,0,3171,1009,0,0,278,2315,111250,2593,22,32
8,5/14/2020,20475,94044,685,3735,0,0,0,0,3217,1062,0,0,318,2951,114519,3269,53,40
8,5/15/2020,20838,97192,685,3789,0,0,0,0,3217,1091,0,0,363,3148,118030,3511,29,54
8,5/16/2020,21232,100608,671,3842,0,0,0,0,3312,878,0,0,394,3416,121840,3810,-213,53
8,5/17/2020,21633,103915,650,3866,0,0,0,0,3346,878,0,0,401,3307,125548,3708,0,24
8,5/18/2020,21938,106557,650,3872,0,0,0,0,3346,878,0,0,305,2642,128495,2947,0,6
8,5/19/2020,22202,109131,626,3899,0,0,0,0,3431,921,0,0,264,2574,131333,2838,43,27
8,5/20/2020,22482,109355,626,3955,0,0,0,0,3478,968,0,0,280,224,131837,504,47,56
8,5/21/2020,22797,112814,613,3990,0,0,0,0,3532,1001,0,0,315,3459,135611,3774,33,35
8,5/22/2020,23191,119034,620,4037,0,0,0,0,3580,1062,0,0,394,6220,142225,6614,61,47
8,5/23/2020,23487,121465,571,4082,0,0,0,0,3612,1088,0,0,296,2431,144952,2727,26,45
8,5/24/2020,23964,126087,538,4105,0,0,0,0,3640,1088,0,0,477,4622,150051,5099,0,23
8,5/25/2020,24174,126134,560,4119,0,0,0,0,3666,1088,0,0,210,47,150308,257,0,14
8,5/26/2020,24269,131742,507,4128,0,0,0,0,3702,1088,0,0,95,5608,156011,5703,0,9
8,5/27/2020,24565,134855,484,4160,0,0,0,0,3741,1114,0,0,296,3113,159420,3409,26,32
8,5/28/2020,24767,138356,464,4196,0,0,0,0,3783,1135,0,0,202,3501,163123,3703,21,36
8,5/29/2020,25121,143838,464,4254,0,0,0,0,3838,1168,0,0,354,5482,168959,5836,33,58
8,5/30/2020,25613,150128,421,4307,0,0,0,0,3859,1181,0,0,492,6290,175741,6782,13,53
8,5/31/2020,26098,154529,414,4333,0,0,0,0,3919,1181,0,0,485,4401,180627,4886,0,26
8,6/1/2020,26378,159998,414,4347,0,0,0,0,3919,1181,0,0,280,5469,186376,5749,0,14
8,6/2/2020,26577,163960,394,4372,0,0,0,0,3954,1185,0,0,199,3962,190537,4161,4,25
8,6/3/2020,26788,167389,388,4419,0,0,0,0,3983,1228,0,0,211,3429,194177,3640,43,47
8,6/4/2020,27060,170140,356,4443,0,0,0,0,4014,1254,0,0,272,2751,197200,3023,26,24
8,6/5/2020,27360,176064,319,4460,0,0,0,0,4034,1255,0,0,300,5924,203424,6224,1,17
8,6/6/2020,27615,180662,299,4472,0,0,0,0,4055,1274,0,0,255,4598,208277,4853,19,12
8,6/7/2020,27848,185166,299,4480,0,0,0,0,4074,1274,0,0,233,4504,213014,4737,0,8
8,6/8/2020,28001,189483,322,4485,0,0,0,0,4091,1274,0,0,153,4317,217484,4470,0,5
8,6/9/2020,28183,193704,304,4859,0,0,0,0,4112,1292,0,0,182,4221,221887,4403,18,374
8,6/10/2020,28347,197747,305,5025,0,0,0,0,4130,1312,0,0,164,4043,226094,4207,20,166
8,6/11/2020,28499,201846,277,5035,0,0,0,0,4150,1328,0,0,152,4099,230345,4251,16,10
8,6/12/2020,28647,205723,279,5057,0,0,0,0,4169,1339,0,0,148,3877,234370,4025,11,22
8,6/13/2020,28822,207639,274,5234,0,0,0,0,4184,1348,0,0,175,1916,236461,2091,9,177
8,6/14/2020,29017,215626,262,5244,0,0,0,0,4178,1348,0,0,195,7987,244643,8182,0,10
8,6/15/2020,29130,219955,276,5244,0,0,0,0,4196,1348,0,0,113,4329,249085,4442,0,0
8,6/16/2020,29299,223857,276,5269,0,0,0,0,4196,1373,0,0,169,3902,253156,4071,25,25
8,6/17/2020,29442,227225,290,5272,0,0,0,0,4231,1373,0,0,143,3368,256667,3511,0,3
8,6/18/2020,29673,232543,270,5294,0,0,0,0,4253,1402,0,0,231,5318,262216,5549,29,22
8,6/19/2020,29901,234545,270,5308,0,0,0,0,4280,1417,0,0,228,2002,264446,2230,15,14
8,6/20/2020,30187,242882,250,5318,0,0,0,0,4296,1429,0,0,286,8337,273069,8623,12,10
8,6/21/2020,30349,248037,255,5323,0,0,0,0,4309,1429,0,0,162,5155,278386,5317,0,5
8,6/22/2020,30539,252233,256,5327,0,0,0,0,4328,1429,0,0,190,4196,282772,4386,0,4
8,6/23/2020,30705,257171,249,5343,0,0,0,0,4342,1438,0,0,166,4938,287876,5104,9,16
8,6/24/2020,30893,259941,238,5366,0,0,0,0,4370,1455,0,0,188,2770,290834,2958,17,23
8,6/25/2020,31155,264910,247,5375,0,0,0,0,4392,1457,0,0,262,4969,296065,5231,2,9
8,6/26/2020,31479,271098,247,5386,0,0,0,0,4412,1475,0,0,324,6188,302577,6512,18,11
8,6/27/2020,31796,275787,226,5392,0,0,0,0,4430,1482,0,0,317,4689,307583,5006,7,6
8,6/28/2020,32022,281689,235,5399,0,0,0,0,4442,1482,0,0,226,5902,313711,6128,0,7
8,6/29/2020,32307,287258,234,5401,0,0,0,0,4459,1482,0,0,285,5569,319565,5854,0,2
8,6/30/2020,32511,291346,271,5442,0,0,0,0,4479,1508,0,0,204,4088,323857,4292,26,41
8,7/1/2020,32715,294788,237,5489,0,0,0,0,4502,1520,0,0,204,3442,327503,3646,12,47
8,7/2/2020,33029,300226,262,5513,0,0,0,0,4524,1520,0,0,314,5438,333255,5752,0,24
8,7/3/2020,33352,306938,270,5527,0,0,0,0,4541,1521,0,0,323,6712,340290,7035,1,14
8,7/4/2020,33619,312135,270,5537,0,0,0,0,4557,1521,0,0,267,5197,345754,5464,0,10
8,7/5/2020,33866,316851,283,5550,0,0,0,0,4568,1521,0,0,247,4716,350717,4963,0,13
8,7/6/2020,34065,321590,286,5565,0,0,0,0,4603,1521,0,0,199,4739,355655,4938,0,15
8,7/7/2020,34257,326383,327,5591,0,0,0,0,4636,1542,0,0,192,4793,360640,4985,21,26
8,7/8/2020,34664,330409,335,5741,0,0,0,0,4669,1542,0,0,407,4026,365073,4433,0,150
8,7/9/2020,35116,335586,335,5820,0,0,0,0,4669,1544,0,0,452,5177,370702,5629,2,79
8,7/10/2020,35525,341615,318,5831,0,0,0,0,4691,1581,0,0,409,6029,377140,6438,37,11
8,7/11/2020,36191,349670,328,5864,0,0,0,0,4728,1586,0,0,666,8055,385861,8721,5,33
8,7/12/2020,36591,355512,324,5885,0,0,0,0,4749,1586,0,0,400,5842,392103,6242,0,21
8,7/13/2020,36913,362452,324,5895,0,0,0,0,4780,1586,0,0,322,6940,399365,7262,0,10
8,7/14/2020,37242,367713,378,5941,0,0,0,0,4808,1589,0,0,329,5261,404955,5590,3,46
8,7/15/2020,37686,372304,368,5963,0,0,0,0,4844,1594,0,0,444,4591,409990,5035,5,22
8,7/16/2020,38155,378061,389,5950,0,0,0,0,4880,1601,0,0,469,5757,416216,6226,7,-13
8,7/17/2020,38726,385623,412,5966,0,0,0,0,4909,1615,0,0,571,7562,424349,8133,14,16
10,3/6/2020,0,10,0,0,0,0,0,0,0,0,0,0,0,0,10,0,0,0
10,3/7/2020,0,10,0,0,0,0,0,0,0,0,0,0,0,0,10,0,0,0
10,3/8/2020,0,10,0,0,0,0,0,0,0,0,0,0,0,0,10,0,0,0
10,3/9/2020,0,15,0,0,0,0,0,0,0,0,0,0,0,5,15,5,0,0
10,3/10/2020,0,17,0,0,0,0,0,0,0,0,0,0,0,2,17,2,0,0
10,3/11/2020,1,17,0,0,0,0,0,0,0,0,0,0,1,0,18,1,0,0
10,3/12/2020,4,23,0,0,0,0,0,0,0,0,0,0,3,6,27,9,0,0
10,3/13/2020,4,30,0,0,0,0,0,0,0,0,0,0,0,7,34,7,0,0
10,3/14/2020,6,36,0,0,0,0,0,0,0,0,0,0,2,6,42,8,0,0
10,3/15/2020,6,36,0,0,0,0,0,0,0,0,0,0,0,0,42,0,0,0
10,3/16/2020,8,36,0,0,0,0,0,0,0,0,0,0,2,0,44,2,0,0
10,3/17/2020,16,36,0,0,0,0,0,0,0,0,0,0,8,0,52,8,0,0
10,3/18/2020,25,36,0,0,0,0,0,0,0,0,0,0,9,0,61,9,0,0
10,3/19/2020,30,36,0,0,0,0,0,0,0,0,0,0,5,0,66,5,0,0
10,3/20/2020,38,36,0,0,0,0,0,0,0,0,0,0,8,0,74,8,0,0
10,3/21/2020,45,36,0,0,0,0,0,0,0,0,0,0,7,0,81,7,0,0
10,3/22/2020,56,36,0,0,0,0,0,0,0,0,0,0,11,0,92,11,0,0
10,3/23/2020,68,36,0,0,0,0,0,0,0,0,0,0,12,0,104,12,0,0
10,3/24/2020,91,36,0,0,0,0,0,0,0,1,1,0,23,0,127,23,1,0
10,3/25/2020,115,36,11,0,0,0,0,0,0,2,2,0,24,0,151,24,1,0
10,3/26/2020,130,36,13,0,0,0,0,0,4,3,3,0,15,0,166,15,1,0
10,3/27/2020,163,36,15,0,0,0,0,0,9,5,5,0,33,0,199,33,2,0
10,3/28/2020,214,36,31,0,0,0,0,0,9,9,9,0,51,0,250,51,4,0
10,3/29/2020,232,36,33,0,0,0,0,0,9,10,10,0,18,0,268,18,1,0
10,3/30/2020,264,2216,45,0,0,0,0,0,9,11,11,0,32,2180,2480,2212,1,0
10,3/31/2020,319,3696,57,0,0,0,0,0,22,12,12,0,55,1480,4015,1535,1,0
10,4/1/2020,368,4015,51,0,0,0,0,0,49,13,13,0,49,319,4383,368,1,0
10,4/2/2020,393,4566,56,0,0,0,0,0,49,16,15,1,25,551,4959,576,3,0
10,4/3/2020,450,4995,63,0,0,0,0,0,71,17,16,1,57,429,5445,486,1,0
10,4/4/2020,593,5874,95,0,0,0,0,0,71,17,16,1,143,879,6467,1022,0,0
10,4/5/2020,673,6321,101,0,0,0,0,0,71,19,16,3,80,447,6994,527,2,0
10,4/6/2020,673,6321,101,0,0,0,0,0,71,24,20,4,0,0,6994,0,5,0
10,4/7/2020,928,7628,147,0,0,0,0,0,144,28,23,5,255,1307,8556,1562,4,0
10,4/8/2020,928,7628,147,0,0,0,0,0,144,32,27,5,0,0,8556,0,4,0
10,4/9/2020,1207,8683,201,0,0,0,0,0,173,34,28,6,279,1055,9890,1334,2,0
10,4/10/2020,1326,10415,181,0,0,0,0,0,177,36,30,6,119,1732,11741,1851,2,0
10,4/11/2020,1479,9624,190,0,0,0,0,0,191,43,37,6,153,-791,11103,-638,7,0
10,4/12/2020,1479,9624,190,0,0,0,0,0,191,48,42,6,0,0,11103,0,5,0
10,4/13/2020,1625,10195,201,0,0,0,0,0,213,53,47,6,146,571,11820,717,5,0
10,4/14/2020,1761,10543,204,0,0,0,0,0,277,60,53,7,136,348,12304,484,7,0
10,4/15/2020,2014,11088,208,0,0,0,0,0,354,67,59,8,253,545,13102,798,7,0
10,4/16/2020,2075,11275,209,0,0,0,0,0,378,70,61,9,61,187,13350,248,3,0
10,4/17/2020,2323,11694,224,0,0,0,0,0,423,76,67,9,248,419,14017,667,6,0
10,4/18/2020,2323,11694,224,0,0,0,0,0,423,86,77,9,0,0,14017,0,10,0
10,4/19/2020,2538,12256,249,0,0,0,0,0,466,90,80,10,215,562,14794,777,4,0
10,4/20/2020,2745,12508,256,0,0,0,0,0,495,99,89,10,207,252,15253,459,9,0
10,4/21/2020,2931,12935,263,0,0,0,0,0,565,104,92,12,186,427,15866,613,5,0
10,4/22/2020,3200,13353,269,0,0,0,0,0,599,117,103,14,269,418,16553,687,13,0
10,4/23/2020,3308,13604,290,0,0,0,0,0,643,131,114,17,108,251,16912,359,14,0
10,4/24/2020,3442,13937,277,0,0,0,0,0,703,147,128,19,134,333,17379,467,16,0
10,4/25/2020,3576,14122,300,0,0,0,0,0,809,155,136,19,134,185,17698,319,8,0
10,4/26/2020,4034,15215,317,0,0,0,0,0,911,168,147,21,458,1093,19249,1551,13,0
10,4/27/2020,4162,15454,325,0,0,0,0,0,996,181,159,22,128,239,19616,367,13,0
10,4/28/2020,4575,16605,337,0,0,0,0,0,1096,192,170,22,413,1151,21180,1564,11,0
10,4/29/2020,4655,16883,326,0,0,0,0,0,1173,204,179,25,80,278,21538,358,12,0
10,4/30/2020,4734,17086,296,0,0,0,0,0,1275,210,185,25,79,203,21820,282,6,0
10,5/1/2020,4918,17667,281,0,0,0,0,0,1403,222,197,25,184,581,22585,765,12,0
10,5/2/2020,5038,18074,300,0,0,0,0,0,1546,235,209,26,120,407,23112,527,13,0
10,5/3/2020,5208,18529,284,0,0,0,0,0,1640,246,220,26,170,455,23737,625,11,0
10,5/4/2020,5288,18822,281,0,0,0,0,0,1716,255,226,29,80,293,24110,373,9,0
10,5/5/2020,5371,19309,284,0,0,0,0,0,1847,266,235,31,83,487,24680,570,11,0
10,5/6/2020,5778,20690,299,0,0,0,0,0,2008,269,237,32,407,1381,26468,1788,3,0
10,5/7/2020,5939,21387,285,0,0,0,0,0,2110,285,253,32,161,697,27326,858,16,0
10,5/8/2020,6111,22153,289,0,0,0,0,0,2288,297,264,33,172,766,28264,938,12,0
10,5/9/2020,6277,23019,288,0,0,0,0,0,2450,301,268,33,166,866,29296,1032,4,0
10,5/10/2020,6447,24592,285,0,0,0,0,0,2537,312,277,35,170,1573,31039,1743,11,0
10,5/11/2020,6565,25363,275,0,0,0,0,0,2619,324,288,36,118,771,31928,889,12,0
10,5/12/2020,6741,26550,276,0,0,0,0,0,2802,334,296,38,176,1187,33291,1363,10,0
10,5/13/2020,6952,27801,282,0,0,0,0,0,2942,351,308,43,211,1251,34753,1462,17,0
10,5/14/2020,7223,29634,273,0,0,0,0,0,3080,362,318,44,271,1833,36857,2104,11,0
10,5/15/2020,7373,30905,269,0,0,0,0,0,3210,373,327,46,150,1271,38278,1421,11,0
10,5/16/2020,7547,32211,250,0,0,0,0,0,3367,383,336,47,174,1306,39758,1480,10,0
10,5/17/2020,7670,33195,229,0,0,0,0,0,3478,392,345,47,123,984,40865,1107,9,0
10,5/18/2020,7869,34589,240,0,0,0,0,0,3545,399,351,48,199,1394,42458,1593,7,0
10,5/19/2020,8037,36095,236,0,0,0,0,0,3760,408,357,51,168,1506,44132,1674,9,0
10,5/20/2020,8194,37218,220,0,0,0,0,0,3965,414,362,52,157,1123,45412,1280,6,0
10,5/21/2020,8386,39156,220,0,0,0,0,0,4130,417,364,53,192,1938,47542,2130,3,0
10,5/22/2020,8529,40457,221,0,0,0,0,0,4296,420,367,53,143,1301,48986,1444,3,0
10,5/23/2020,8690,41844,210,0,0,0,0,0,4454,425,371,54,161,1387,50534,1548,5,0
10,5/24/2020,8809,43061,211,0,0,0,0,0,4598,431,377,54,119,1217,51870,1336,6,0
10,5/25/2020,8965,44931,205,0,0,0,0,0,4693,436,382,54,156,1870,53896,2026,5,0
10,5/26/2020,9066,45848,201,0,0,0,0,0,4802,444,389,55,101,917,54914,1018,8,0
10,5/27/2020,9096,46325,196,0,0,0,0,0,4909,453,397,56,30,477,55421,507,9,0
10,5/28/2020,9171,47630,192,0,0,0,0,0,5010,459,402,57,75,1305,56801,1380,6,0
10,5/29/2020,9236,48297,183,0,0,0,0,0,5103,463,406,57,65,667,57533,732,4,0
10,5/30/2020,9422,49907,174,0,0,0,0,0,5205,466,409,57,186,1610,59329,1796,3,0
10,5/31/2020,9498,51173,160,0,0,0,0,0,5266,468,411,57,76,1266,60671,1342,2,0
10,6/1/2020,9605,52842,159,0,0,0,0,0,5353,471,414,57,107,1669,62447,1776,3,0
10,6/2/2020,9685,54377,157,0,0,0,0,0,5442,471,414,57,80,1535,64062,1615,0,0
10,6/3/2020,9712,55208,153,0,0,0,0,0,5493,475,418,57,27,831,64920,858,4,0
10,6/4/2020,9746,56163,142,0,0,0,0,0,5562,483,425,58,34,955,65909,989,8,0
10,6/5/2020,9773,56956,128,0,0,0,0,0,5631,485,427,58,27,793,66729,820,2,0
10,6/6/2020,9845,57790,117,0,0,0,0,0,5696,485,427,58,72,834,67635,906,0,0
10,6/7/2020,9942,59055,103,0,0,0,0,0,5792,488,430,58,97,1265,68997,1362,3,0
10,6/8/2020,9972,59975,113,0,0,0,0,0,5791,490,432,58,30,920,69947,950,2,0
10,6/9/2020,10020,60733,108,0,0,0,0,0,5888,492,434,58,48,758,70753,806,2,0
10,6/10/2020,10056,61689,108,0,0,0,0,0,5939,493,435,58,36,956,71745,992,1,0
10,6/11/2020,10106,63927,109,0,0,0,0,0,6001,494,436,58,50,2238,74033,2288,1,0
10,6/12/2020,10173,67521,100,0,0,0,0,0,6062,494,436,58,67,3594,77694,3661,0,0
10,6/13/2020,10229,69870,93,0,0,0,0,0,6116,495,437,58,56,2349,80099,2405,1,0
10,6/14/2020,10264,71523,93,0,0,0,0,0,6172,496,438,58,35,1653,81787,1688,1,0
10,6/15/2020,10340,74346,88,0,0,0,0,0,6172,498,440,58,76,2823,84686,2899,2,0
10,6/16/2020,10403,75671,87,0,0,0,0,0,6256,499,441,58,63,1325,86074,1388,1,0
10,6/17/2020,10444,76143,83,0,0,0,0,0,6305,502,444,58,41,472,86587,513,3,0
10,6/18/2020,10499,78185,79,0,0,0,0,0,6350,502,444,58,55,2042,88684,2097,0,0
10,6/19/2020,10611,79823,75,0,0,0,0,0,6395,504,446,58,112,1638,90434,1750,2,0
10,6/20/2020,10681,81735,75,0,0,0,0,0,6395,504,446,58,70,1912,92416,1982,0,0
10,6/21/2020,10775,84199,79,0,0,0,0,0,6459,504,446,58,94,2464,94974,2558,0,0
10,6/22/2020,10820,85903,89,0,0,0,0,0,6459,504,446,58,45,1704,96723,1749,0,0
10,6/23/2020,10847,86689,91,0,0,0,0,0,6554,504,446,58,27,786,97536,813,0,0
10,6/24/2020,10889,87312,85,0,0,0,0,0,6598,505,447,58,42,623,98201,665,1,0
10,6/25/2020,10980,90012,93,0,0,0,0,0,6646,507,449,58,91,2700,100992,2791,2,0
10,6/26/2020,11017,91083,78,0,0,0,0,0,6661,507,449,58,37,1071,102100,1108,0,0
10,6/27/2020,11091,93171,83,0,15,0,0,0,6665,507,449,58,74,2088,104262,2162,0,0
10,6/28/2020,11226,95120,78,0,14,0,0,0,6665,507,449,58,135,1949,106346,2084,0,0
10,6/29/2020,11376,98555,72,0,15,0,0,0,6665,507,449,58,150,3435,109931,3585,0,0
10,6/30/2020,11474,99407,64,0,13,0,0,0,6667,509,451,58,98,852,110881,950,2,0
10,7/1/2020,11510,99874,68,0,13,0,0,0,6676,509,451,58,36,467,111384,503,0,0
10,7/2/2020,11731,103187,67,0,16,0,0,0,6678,510,453,57,221,3313,114918,3534,1,0
10,7/3/2020,11923,106420,57,0,13,0,0,0,6692,512,455,57,192,3233,118343,3425,2,0
10,7/4/2020,11996,108697,54,0,13,0,0,0,6711,512,455,57,73,2277,120693,2350,0,0
10,7/5/2020,12128,111813,53,0,15,0,0,0,6740,512,455,57,132,3116,123941,3248,0,0
10,7/6/2020,12293,114886,54,0,15,0,0,0,6778,512,455,57,165,3073,127179,3238,0,0
10,7/7/2020,12414,116271,56,0,15,0,0,0,6815,514,457,57,121,1385,128685,1506,2,0
10,7/8/2020,12462,116572,57,0,11,0,0,0,6851,515,458,57,48,301,129034,349,1,0
10,7/9/2020,12531,117674,63,0,12,0,0,0,6901,517,460,57,69,1102,130205,1171,2,0
10,7/10/2020,12652,120056,58,0,11,0,0,0,6949,517,460,57,121,2382,132708,2503,0,0
10,7/11/2020,12743,121372,65,0,13,0,0,0,7002,517,460,57,91,1316,134115,1407,0,0
10,7/12/2020,12804,124605,58,0,10,0,0,0,7120,517,459,58,61,3233,137409,3294,0,0
10,7/13/2020,12879,126484,49,0,12,0,0,0,7139,517,459,58,75,1879,139363,1954,0,0
10,7/14/2020,12969,128631,48,0,10,0,0,0,7184,518,460,58,90,2147,141600,2237,1,0
10,7/15/2020,13050,130338,51,0,11,0,0,0,7236,521,463,58,81,1707,143388,1788,3,0
10,7/16/2020,13114,131756,50,0,8,0,0,0,7269,521,463,58,64,1418,144870,1482,0,0
10,7/17/2020,13337,135273,55,0,7,0,0,0,7315,521,463,58,223,3517,148610,3740,0,0
11,3/5/2020,0,6,0,0,0,0,0,0,0,0,0,0,0,0,6,0,0,0
11,3/6/2020,0,8,0,0,0,0,0,0,0,0,0,0,0,2,8,2,0,0
11,3/7/2020,0,8,0,0,0,0,0,0,0,0,0,0,0,0,8,0,0,0
11,3/8/2020,1,10,0,0,0,0,0,0,0,0,0,0,1,2,11,3,0,0
11,3/9/2020,1,14,0,0,0,0,0,0,0,0,0,0,0,4,15,4,0,0
11,3/10/2020,5,17,0,0,0,0,0,0,0,0,0,0,4,3,22,7,0,0
11,3/11/2020,5,20,0,0,0,0,0,0,0,0,0,0,0,3,25,3,0,0
11,3/12/2020,10,20,0,0,0,0,0,0,0,0,0,0,5,0,30,5,0,0
11,3/13/2020,10,20,0,0,0,0,0,0,0,0,0,0,0,0,30,0,0,0
11,3/14/2020,10,49,0,0,0,0,0,0,0,0,0,0,0,29,59,29,0,0
11,3/15/2020,16,79,0,0,0,0,0,0,0,0,0,0,6,30,95,36,0,0
11,3/16/2020,17,96,0,0,0,0,0,0,0,0,0,0,1,17,113,18,0,0
11,3/17/2020,22,104,0,0,0,0,0,0,0,0,0,0,5,8,126,13,0,0
11,3/18/2020,31,138,0,0,0,0,0,0,0,0,0,0,9,34,169,43,0,0
11,3/19/2020,39,153,0,0,0,0,0,0,0,0,0,0,8,15,192,23,0,0
11,3/20/2020,71,501,0,0,0,0,0,0,0,1,0,0,32,348,572,380,1,0
11,3/21/2020,77,506,0,0,0,0,0,0,0,1,0,0,6,5,583,11,0,0
11,3/22/2020,98,957,0,0,0,0,0,0,0,1,0,0,21,451,1055,472,0,0
11,3/23/2020,116,1113,0,0,0,0,0,0,0,2,0,0,18,156,1229,174,1,0
11,3/24/2020,137,1195,0,0,0,0,0,0,0,2,0,0,21,82,1332,103,0,0
11,3/25/2020,183,1423,0,0,0,0,0,0,0,2,0,0,46,228,1606,274,0,0
11,3/26/2020,231,1626,0,0,0,0,0,0,21,3,0,0,48,203,1857,251,1,0
11,3/27/2020,267,1897,0,0,0,0,0,0,49,3,0,0,36,271,2164,307,0,0
11,3/28/2020,304,2211,0,0,0,0,0,0,51,4,0,0,37,314,2515,351,1,0
11,3/29/2020,342,2469,0,0,0,0,0,0,66,5,0,0,38,258,2811,296,1,0
11,3/30/2020,401,2682,0,0,0,0,0,0,106,9,0,0,59,213,3083,272,4,0
11,3/31/2020,495,3262,0,0,0,0,0,0,121,9,0,0,94,580,3757,674,0,0
11,4/1/2020,586,3262,0,0,0,0,0,0,142,11,0,0,91,0,3848,91,2,0
11,4/2/2020,653,4417,0,0,0,0,0,0,173,12,0,0,67,1155,5070,1222,1,0
11,4/3/2020,757,4827,0,0,0,0,0,0,206,15,0,0,104,410,5584,514,3,0
11,4/4/2020,902,5536,0,0,0,0,0,0,235,21,0,0,145,709,6438,854,6,0
11,4/5/2020,998,5836,0,0,0,0,0,0,258,22,0,0,96,300,6834,396,1,0
11,4/6/2020,1097,6356,0,0,0,0,0,0,287,24,0,0,99,520,7453,619,2,0
11,4/7/2020,1211,6612,0,0,0,0,0,0,318,22,0,0,114,256,7823,370,-2,0
11,4/8/2020,1440,6843,0,0,0,0,0,0,361,27,0,0,229,231,8283,460,5,0
11,4/9/2020,1523,7201,0,0,0,0,0,0,393,32,0,0,83,358,8724,441,5,0
11,4/10/2020,1660,7695,0,0,0,0,0,0,426,38,0,0,137,494,9355,631,6,0
11,4/11/2020,1778,8261,0,0,0,0,0,0,447,47,0,0,118,566,10039,684,9,0
11,4/12/2020,1875,8765,0,0,0,0,0,0,493,50,0,0,97,504,10640,601,3,0
11,4/13/2020,1955,8979,295,0,95,0,31,0,507,53,0,0,80,214,10934,294,3,0
11,4/14/2020,2058,9226,295,0,95,0,31,0,518,67,0,0,103,247,11284,350,14,0
11,4/15/2020,2197,9328,313,0,105,0,79,0,530,72,0,0,139,102,11525,241,5,0
11,4/16/2020,2350,9800,313,0,105,0,79,0,552,81,0,0,153,472,12150,625,9,0
11,4/17/2020,2476,10167,313,0,105,0,79,0,573,86,0,0,126,367,12643,493,5,0
11,4/18/2020,2666,10602,313,0,105,0,79,0,608,91,0,0,190,435,13268,625,5,0
11,4/19/2020,2793,10906,313,0,105,0,79,0,622,96,0,0,127,304,13699,431,5,0
11,4/20/2020,2927,11186,402,0,120,0,69,0,630,105,0,0,134,280,14113,414,9,0
11,4/21/2020,3098,11841,402,0,120,0,69,0,636,112,0,0,171,655,14939,826,7,0
11,4/22/2020,3206,12296,402,0,120,0,69,0,645,127,0,0,108,455,15502,563,15,0
11,4/23/2020,3361,12569,402,0,120,0,200,0,648,139,0,0,155,273,15930,428,12,0
11,4/24/2020,3528,13005,402,0,120,0,69,0,651,153,0,0,167,436,16533,603,14,0
11,4/25/2020,3699,13603,402,0,120,0,69,0,652,165,0,0,171,598,17302,769,12,0
11,4/26/2020,3841,14227,402,0,120,0,69,0,657,178,0,0,142,624,18068,766,13,0
11,4/27/2020,3892,14524,402,0,0,0,0,0,659,185,0,0,51,297,18416,348,7,0
11,4/28/2020,3994,14891,0,0,0,0,0,0,660,190,0,0,102,367,18885,469,5,0
11,4/29/2020,4106,15123,0,0,0,0,0,0,660,205,0,0,112,232,19229,344,15,0
11,4/30/2020,4323,15756,0,0,0,0,0,0,660,224,0,0,217,633,20079,850,19,0
11,5/1/2020,4658,16477,0,0,0,0,0,0,666,231,0,0,335,721,21135,1056,7,0
11,5/2/2020,4797,17207,0,0,0,0,0,0,666,240,0,0,139,730,22004,869,9,0
11,5/3/2020,5016,18086,0,0,0,0,0,0,666,251,0,0,219,879,23102,1098,11,0
11,5/4/2020,5170,18625,447,0,130,0,91,0,666,258,0,0,154,539,23795,693,7,0
11,5/5/2020,5322,19007,447,0,130,0,91,0,667,264,0,0,152,382,24329,534,6,0
11,5/6/2020,5461,19523,447,0,130,0,91,0,808,277,0,0,139,516,24984,655,13,0
11,5/7/2020,5654,20202,447,0,130,0,91,0,825,285,0,0,193,679,25856,872,8,0
11,5/8/2020,5899,21216,447,0,130,0,91,0,825,304,0,0,245,1014,27115,1259,19,0
11,5/9/2020,6102,22081,447,0,130,0,91,0,879,311,0,0,203,865,28183,1068,7,0
11,5/10/2020,6272,23298,447,0,130,0,91,0,880,323,0,0,170,1217,29570,1387,12,0
11,5/11/2020,6389,23872,416,0,0,0,82,0,881,328,0,0,117,574,30261,691,5,0
11,5/12/2020,6485,24565,416,0,0,0,82,0,886,336,0,0,96,693,31050,789,8,0
11,5/13/2020,6584,25074,423,0,0,0,82,0,934,350,0,0,99,509,31658,608,14,0
11,5/14/2020,6736,26263,397,0,0,0,90,0,966,358,0,0,152,1189,32999,1341,8,0
11,5/15/2020,6871,27468,393,0,0,0,90,0,975,368,0,0,135,1205,34339,1340,10,0
11,5/16/2020,7042,28490,382,0,0,0,79,0,998,375,0,0,171,1022,35532,1193,7,0
11,5/17/2020,7123,29403,369,0,0,0,74,0,1023,383,0,0,81,913,36526,994,8,0
11,5/18/2020,7270,30555,374,0,0,0,70,0,1028,392,0,0,147,1152,37825,1299,9,0
11,5/19/2020,7434,31940,375,0,0,0,77,0,1040,400,0,0,164,1385,39374,1549,8,0
11,5/20/2020,7551,32868,336,0,0,0,74,0,1059,407,0,0,117,928,40419,1045,7,0
11,5/21/2020,7788,33968,336,0,0,0,74,0,1061,412,0,0,237,1100,41756,1337,5,0
11,5/22/2020,7893,35100,342,0,112,0,74,0,1069,418,0,0,105,1132,42993,1237,6,0
11,5/23/2020,7966,44025,324,0,110,0,73,0,1075,427,0,0,73,8925,51991,8998,9,0
11,5/24/2020,7966,44025,324,0,110,0,73,0,1075,427,0,0,0,0,51991,0,0,0
11,5/25/2020,8225,32578,331,0,106,0,70,0,1080,440,0,0,259,-11447,40803,-11188,13,0
11,5/26/2020,8334,33721,353,0,113,0,76,0,1080,440,0,0,109,1143,42055,1252,0,0
11,5/27/2020,8406,34291,349,0,113,0,76,0,1082,445,0,0,72,570,42697,642,5,0
11,5/28/2020,8492,35022,343,0,108,0,65,0,1082,453,0,0,86,731,43514,817,8,0
11,5/29/2020,8538,35320,338,0,114,0,65,0,1089,460,0,0,46,298,43858,344,7,0
11,5/30/2020,8717,36912,317,0,109,0,66,0,1100,462,0,0,179,1592,45629,1771,2,0
11,5/31/2020,8801,37682,295,0,109,0,66,0,1116,466,0,0,84,770,46483,854,4,0
11,6/1/2020,8857,38406,302,0,108,0,67,0,1126,468,0,0,56,724,47263,780,2,0
11,6/2/2020,8886,38815,295,0,106,0,74,0,1137,470,0,0,29,409,47701,438,2,0
11,6/3/2020,9016,40546,285,0,103,0,72,0,1138,473,0,0,130,1731,49562,1861,3,0
11,6/4/2020,9120,41976,276,0,98,0,73,0,1138,475,0,0,104,1430,51096,1534,2,0
11,6/5/2020,9199,42662,273,0,99,0,75,0,1138,475,0,0,79,686,51861,765,0,0
11,6/6/2020,9269,44409,276,0,100,0,68,0,1138,483,0,0,70,1747,53678,1817,8,0
11,6/7/2020,9332,45215,285,0,90,0,73,0,1143,489,0,0,63,806,54547,869,6,0
11,6/8/2020,9389,46377,268,0,102,0,72,0,1143,491,0,0,57,1162,55766,1219,2,0
11,6/9/2020,9474,47678,255,0,89,0,59,0,1143,495,0,0,85,1301,57152,1386,4,0
11,6/10/2020,9537,48655,245,0,79,0,60,0,1143,499,0,0,63,977,58192,1040,4,0
11,6/11/2020,9589,49699,238,0,82,0,53,0,1143,502,0,0,52,1044,59288,1096,3,0
11,6/12/2020,9654,52299,212,0,82,0,57,0,1143,506,0,0,65,2600,61953,2665,4,0
11,6/13/2020,9709,53327,197,0,78,0,52,0,1143,511,0,0,55,1028,63036,1083,5,0
11,6/14/2020,9767,54763,186,0,71,0,50,0,1150,515,0,0,58,1436,64530,1494,4,0
11,6/15/2020,9799,56047,191,0,76,0,48,0,1155,515,0,0,32,1284,65846,1316,0,0
11,6/16/2020,9818,57308,192,0,70,0,49,0,1155,520,0,0,19,1261,67126,1280,5,0
11,6/17/2020,9847,60239,197,0,73,0,47,0,1155,523,0,0,29,2931,70086,2960,3,0
11,6/18/2020,9903,62296,189,0,86,0,45,0,1155,527,0,0,56,2057,72199,2113,4,0
11,6/19/2020,9952,63839,184,0,63,0,44,0,1162,530,0,0,49,1543,73791,1592,3,0
11,6/20/2020,9984,67969,177,0,58,0,40,0,1166,531,0,0,32,4130,77953,4162,1,0
11,6/21/2020,10020,69502,168,0,61,0,37,0,1172,533,0,0,36,1533,79522,1569,2,0
11,6/22/2020,10058,71946,155,0,50,0,34,0,1182,535,0,0,38,2444,82004,2482,2,0
11,6/23/2020,10094,73208,171,0,61,0,40,0,1182,537,0,0,36,1262,83302,1298,2,0
11,6/24/2020,10128,74045,167,0,58,0,36,0,1182,541,0,0,34,837,84173,871,4,0
11,6/25/2020,10159,76572,157,0,53,0,34,0,1182,543,0,0,31,2527,86731,2558,2,0
11,6/26/2020,10185,77938,147,0,48,0,29,0,1186,546,0,0,26,1366,88123,1392,3,0
11,6/27/2020,10216,79055,136,0,43,0,26,0,1194,548,0,0,31,1117,89271,1148,2,0
11,6/28/2020,10248,82884,126,0,34,0,27,0,1199,550,0,0,32,3829,93132,3861,2,0
11,6/29/2020,10292,85068,121,0,34,0,23,0,1200,551,0,0,44,2184,95360,2228,1,0
11,6/30/2020,10327,86968,126,0,33,0,22,0,1270,551,0,0,35,1900,97295,1935,0,0
11,7/1/2020,10365,89670,119,0,33,0,26,0,1451,553,0,0,38,2702,100035,2740,2,0
11,7/2/2020,10390,90673,120,0,33,0,28,0,1465,554,0,0,25,1003,101063,1028,1,0
11,7/3/2020,10435,92374,110,0,38,0,24,0,1497,555,0,0,45,1701,102809,1746,1,0
11,7/4/2020,10447,94107,95,0,28,0,21,0,1523,557,0,0,12,1733,104554,1745,2,0
11,7/5/2020,10482,95511,87,0,26,0,18,0,1542,559,0,0,35,1404,105993,1439,2,0
11,7/6/2020,10515,97135,88,0,23,0,16,0,1553,561,0,0,33,1624,107650,1657,2,0
11,7/7/2020,10569,99808,90,0,25,0,20,0,1574,561,0,0,54,2673,110377,2727,0,0
11,7/8/2020,10642,103647,86,0,30,0,17,0,1625,564,0,0,73,3839,114289,3912,3,0
11,7/9/2020,10679,105244,92,0,26,0,14,0,1662,568,0,0,37,1597,115923,1634,4,0
11,7/10/2020,10743,110141,96,0,26,0,18,0,1703,568,0,0,64,4897,120884,4961,0,0
11,7/11/2020,10801,113249,92,0,29,0,17,0,1717,568,0,0,58,3108,124050,3166,0,0
11,7/12/2020,10847,116036,95,0,30,0,17,0,1737,568,0,0,46,2787,126883,2833,0,0
11,7/13/2020,10906,119314,93,0,25,0,16,0,1756,568,0,0,59,3278,130220,3337,0,0
11,7/14/2020,10946,122970,91,0,21,0,14,0,1774,568,0,0,40,3656,133916,3696,0,0
11,7/15/2020,11026,126918,95,0,24,0,15,0,1809,571,0,0,80,3948,137944,4028,3,0
11,7/16/2020,11076,129166,86,0,24,0,14,0,1843,574,0,0,50,2248,140242,2298,3,0
11,7/17/2020,11115,130492,87,0,17,0,14,0,1863,577,0,0,39,1326,141607,1365,3,0
9,3/7/2020,0,0,0,0,0,0,0,0,0,0,0,0,0,0,0,0,0,0
9,3/8/2020,1,29,0,0,0,0,0,0,0,0,0,0,1,29,30,30,0,0
9,3/9/2020,1,46,0,0,0,0,0,0,0,0,0,0,0,17,47,17,0,0
9,3/10/2020,2,54,0,0,0,0,0,0,0,0,0,0,1,8,56,9,0,0
9,3/11/2020,3,71,0,0,0,0,0,0,0,0,0,0,1,17,74,18,0,0
9,3/12/2020,6,89,0,0,0,0,0,0,0,0,0,0,3,18,95,21,0,0
9,3/13/2020,6,99,0,0,0,0,0,0,0,0,0,0,0,10,105,10,0,0
9,3/14/2020,11,125,0,0,0,0,0,0,0,0,0,0,5,26,136,31,0,0
9,3/15/2020,20,125,0,0,0,0,0,0,0,0,0,0,9,0,145,9,0,0
9,3/16/2020,26,125,0,0,0,0,0,0,0,0,0,0,6,0,151,6,0,0
9,3/17/2020,41,125,0,0,0,0,0,0,0,0,0,0,15,0,166,15,0,0
9,3/18/2020,68,125,0,0,0,0,0,0,0,0,0,0,27,0,193,27,0,0
9,3/19/2020,96,604,0,0,0,0,0,0,0,1,0,0,28,479,700,507,1,0
9,3/20/2020,194,604,0,0,0,0,0,0,0,3,0,0,98,0,798,98,2,0
9,3/21/2020,194,2106,0,0,0,0,0,0,0,4,0,0,0,1502,2300,1502,1,0
9,3/22/2020,223,2877,43,0,0,0,0,0,0,5,0,0,29,771,3100,800,1,0
9,3/23/2020,415,4085,54,0,0,0,0,0,0,10,0,0,192,1208,4500,1400,5,0
9,3/24/2020,618,4682,71,0,0,0,0,0,0,12,1,0,203,597,5300,800,2,0
9,3/25/2020,875,5023,113,0,0,0,0,0,0,19,3,0,257,341,5898,598,7,0
9,3/26/2020,1012,5625,125,0,0,0,0,0,0,21,4,0,137,602,6637,739,2,0
9,3/27/2020,1291,7109,173,0,0,0,0,0,0,27,5,0,279,1484,8400,1763,6,0
9,3/28/2020,1291,7109,173,0,0,0,0,0,0,27,10,0,0,0,8400,0,0,0
9,3/29/2020,1993,9907,404,0,0,0,0,0,0,34,12,0,702,2798,11900,3500,7,0
9,3/30/2020,2571,12029,517,0,0,0,0,0,0,36,19,0,578,2122,14600,2700,2,0
9,3/31/2020,3128,13029,608,0,0,0,0,0,0,69,21,0,557,1000,16157,1557,33,0
9,4/1/2020,3557,13043,766,0,0,0,0,0,0,85,27,0,429,14,16600,443,16,0
9,4/2/2020,3824,14476,827,0,0,0,0,0,0,112,27,0,267,1433,18300,1700,27,0
9,4/3/2020,4914,15101,909,0,0,0,0,0,0,131,34,0,1090,625,20015,1715,19,0
9,4/4/2020,5276,16753,1033,0,0,0,0,0,0,165,36,0,362,1652,22029,2014,34,0
9,4/5/2020,5675,17595,1142,0,0,0,0,0,0,189,69,0,399,842,23270,1241,24,0
9,4/6/2020,6906,19780,1221,0,0,0,0,0,0,206,85,0,1231,2185,26686,3416,17,0
9,4/7/2020,7781,21255,1308,0,0,0,0,0,0,277,112,0,875,1475,29036,2350,71,0
9,4/8/2020,7781,21255,1308,0,0,0,0,0,0,277,131,0,0,0,29036,0,0,0
9,4/9/2020,9784,23718,1464,0,0,0,0,0,0,380,165,0,2003,2463,33502,4466,103,0
9,4/10/2020,10538,25750,1562,0,0,0,0,0,0,448,189,0,754,2032,36288,2786,68,0
9,4/11/2020,11510,28321,1593,0,0,0,0,0,0,494,206,0,972,2571,39831,3543,46,0
9,4/12/2020,12035,29185,1654,0,0,0,0,0,0,554,277,0,525,864,41220,1389,60,0
9,4/13/2020,13381,30928,1760,0,0,0,0,0,0,602,277,0,1346,1743,44309,3089,48,0
9,4/14/2020,13989,31852,1779,0,0,0,0,0,0,671,380,0,608,924,45841,1532,69,0
9,4/15/2020,14755,35388,1908,0,0,0,0,0,0,868,448,0,766,3536,50143,4302,197,0
9,4/16/2020,15884,37238,1926,0,0,0,0,0,0,971,494,0,1129,1850,53122,2979,103,0
9,4/17/2020,16809,38653,1946,0,0,0,0,0,0,1036,554,0,925,1415,55462,2340,65,0
9,4/18/2020,16809,38653,1946,0,0,0,0,0,0,1036,602,0,0,0,55462,0,0,0
9,4/19/2020,17550,40663,1938,0,0,0,0,0,0,1086,671,0,741,2010,58213,2751,50,0
9,4/20/2020,19815,42991,1919,0,0,0,0,0,0,1331,868,0,2265,2328,62806,4593,245,0
9,4/21/2020,20360,43832,1949,0,0,0,0,0,0,1423,971,0,545,841,64192,1386,92,0
9,4/22/2020,22469,47449,1972,0,0,0,0,0,0,1544,1036,0,2109,3617,69918,5726,121,0
9,4/23/2020,23100,48397,1947,0,0,0,0,0,0,1639,1036,0,631,948,71497,1579,95,0
9,4/24/2020,23921,50117,1877,0,0,0,0,0,0,1764,1086,0,821,1720,74038,2541,125,0
9,4/25/2020,24582,53020,1810,0,0,0,0,0,0,1862,1331,0,661,2903,77602,3564,98,0
9,4/26/2020,25269,54542,1766,0,0,0,0,0,0,1924,1423,0,687,1522,79811,2209,62,0
9,4/27/2020,25269,54542,1758,0,0,0,0,0,0,1998,1544,0,0,0,79811,0,74,0
9,4/28/2020,26312,66433,1732,0,0,0,0,0,0,2089,1639,0,1043,11891,92745,12934,91,0
9,4/29/2020,26767,68051,1691,0,0,0,0,0,0,2168,1764,0,455,1618,94818,2073,79,0
9,4/30/2020,27700,69433,1650,0,0,0,0,0,0,2257,1862,0,933,1382,97133,2315,89,0
9,5/1/2020,28764,71493,1592,7758,0,0,0,0,4346,2339,1924,0,1064,2060,100257,3124,82,7758
9,5/2/2020,28764,71493,1592,7758,0,0,0,0,4346,2339,1998,0,0,0,100257,0,0,0
9,5/3/2020,29287,73206,1551,7758,0,0,0,0,4346,2436,2089,0,523,1713,102493,2236,97,0
9,5/4/2020,29287,73206,1488,7758,0,0,0,0,4346,2495,2168,0,0,0,102493,0,59,0
9,5/5/2020,30621,78022,1500,7758,0,0,0,0,4346,2633,2257,0,1334,4816,108643,6150,138,0
9,5/6/2020,30995,80452,1445,7758,0,0,0,0,4346,2718,2339,0,374,2430,111447,2804,85,0
9,5/7/2020,31784,84390,1385,9389,0,0,0,0,5413,2797,2339,0,789,3938,116174,4727,79,1631
9,5/8/2020,32411,88130,1327,9389,0,0,0,0,5413,2874,2436,0,627,3740,120541,4367,77,0
9,5/9/2020,32984,90585,1301,9389,0,0,0,0,5413,2932,2495,0,573,2455,123569,3028,58,0
9,5/10/2020,33554,96638,1242,9389,0,0,0,0,5413,2967,2633,0,570,6053,130192,6623,35,0
9,5/11/2020,33765,98743,1212,9389,0,0,0,0,5413,3008,2718,0,211,2105,132508,2316,41,0
9,5/12/2020,34333,104091,1189,9389,0,0,0,0,5413,3041,0,0,568,5348,138424,5916,33,0
9,5/13/2020,34855,108088,1158,9389,0,0,0,0,5413,3125,0,0,522,3997,142943,4519,84,0
9,5/14/2020,35464,114098,1103,10946,0,0,0,0,6264,3219,0,0,609,6010,149562,6619,94,1557
9,5/15/2020,36085,119823,1033,10946,0,0,0,0,6264,3285,0,0,621,5725,155908,6346,66,0
9,5/16/2020,36703,128052,994,10946,0,0,0,0,6264,3339,0,0,618,8229,164755,8847,54,0
9,5/17/2020,37419,133188,937,10946,0,0,0,0,6264,3408,0,0,716,5136,170607,5852,69,0
9,5/18/2020,38116,139563,920,10946,0,0,0,0,6264,3449,0,0,697,6375,177679,7072,41,0
9,5/19/2020,38430,147090,914,10946,0,0,0,0,6264,3472,0,0,314,7527,185520,7841,23,0
9,5/20/2020,39017,151701,887,10946,0,0,0,0,6264,3529,0,0,587,4611,190718,5198,57,0
9,5/21/2020,39208,157239,816,10946,0,0,0,0,6264,3582,0,0,191,5538,196447,5729,53,0
9,5/22/2020,39640,162688,740,12538,0,0,0,0,7127,3637,0,0,432,5449,202328,5881,55,1592
9,5/23/2020,40022,168345,724,12538,0,0,0,0,7127,3675,0,0,382,5657,208367,6039,38,0
9,5/24/2020,40468,173668,701,12538,0,0,0,0,7127,3693,0,0,446,5323,214136,5769,18,0
9,5/25/2020,40873,180853,706,12538,0,0,0,0,7127,3742,0,0,405,7185,221726,7590,49,0
9,5/26/2020,41303,184059,694,12538,0,0,0,0,7127,3769,0,0,430,3206,225362,3636,27,0
9,5/27/2020,41288,187581,684,12538,0,0,0,0,7127,3803,0,0,-15,3522,228869,3507,34,0
9,5/28/2020,41559,193966,648,12538,0,0,0,0,7127,3826,0,0,271,6385,235525,6656,23,0
9,5/29/2020,41762,199631,577,12538,0,0,0,0,7127,3868,0,0,203,5665,241393,5868,42,0
9,5/30/2020,42022,204913,533,12538,0,0,0,0,7127,3912,0,0,260,5282,246935,5542,44,0
9,5/31/2020,42201,207845,481,12538,0,0,0,0,7127,3944,0,0,179,2932,250046,3111,32,0
9,6/1/2020,42740,218650,454,13793,0,0,0,0,7511,3964,3110,854,539,10805,261390,11344,20,1255
9,6/2/2020,42979,227631,434,13793,0,0,0,0,7511,3972,3139,833,239,8981,270610,9220,8,0
9,6/3/2020,43091,233345,406,13793,0,0,0,0,7511,3989,3156,833,112,5714,276436,5826,17,0
9,6/4/2020,43239,238286,373,9669,0,0,0,0,7284,4007,3171,836,148,4941,281525,5089,18,-4124
9,6/5/2020,43460,243927,350,9669,0,0,0,0,7284,4038,3196,842,221,5641,287387,5862,31,0
9,6/6/2020,43818,251731,333,9669,0,0,0,0,7284,4055,3218,837,358,7804,295549,8162,17,0
9,6/7/2020,43968,258386,333,9669,0,0,0,0,7284,4071,3229,842,150,6655,302354,6805,16,0
9,6/8/2020,44092,263979,324,9669,0,0,0,0,7284,4084,3239,845,124,5593,308071,5717,13,0
9,6/9/2020,44179,268472,293,9669,0,0,0,0,7284,4097,3266,831,87,4493,312651,4580,13,0
9,6/10/2020,44347,272566,270,9669,0,0,0,0,7284,4120,3283,837,168,4094,316913,4262,23,0
9,6/11/2020,44461,277487,246,9912,0,0,0,0,7611,4146,3308,838,114,4921,321948,5035,26,243
9,6/12/2020,44689,285565,244,9912,0,0,0,0,7611,4159,3321,838,228,8078,330254,8306,13,0
9,6/13/2020,44994,299260,233,9912,0,0,0,0,7611,4186,3342,844,305,13695,344254,14000,27,0
9,6/14/2020,45088,304018,205,9912,0,0,0,0,7611,4201,3355,846,94,4758,349106,4852,15,0
9,6/15/2020,45235,311142,203,9912,0,0,0,0,7611,4204,3356,848,147,7124,356377,7271,3,0
9,6/16/2020,45349,316071,201,9912,0,0,0,0,7611,4210,3362,848,114,4929,361420,5043,6,0
9,6/17/2020,45429,322429,186,9912,0,0,0,0,7611,4219,3373,846,80,6358,367858,6438,9,0
9,6/18/2020,45440,327145,176,10099,0,0,0,0,7842,4226,3378,848,11,4716,372585,4727,7,187
9,6/19/2020,45557,334321,172,10099,0,0,0,0,7842,4238,3385,853,117,7176,379878,7293,12,0
9,6/20/2020,45715,345940,150,10099,0,0,0,0,7842,4251,3394,857,158,11619,391655,11777,13,0
9,6/21/2020,45755,349673,149,10099,0,0,0,0,7842,4260,3401,859,40,3733,395428,3773,9,0
9,6/22/2020,45782,351770,140,10099,0,0,0,0,7842,4263,3403,860,27,2097,397552,2124,3,0
9,6/23/2020,45899,358045,138,10099,0,0,0,0,7842,4277,3414,863,117,6275,403944,6392,14,0
9,6/24/2020,45913,356437,124,10099,0,0,0,0,7842,4287,3423,864,14,-1608,402350,-1594,10,0
9,6/25/2020,45994,362949,122,10268,0,0,0,0,8053,4298,3434,864,81,6512,408943,6593,11,169
9,6/26/2020,46059,370803,127,10268,0,0,0,0,8053,4307,3440,867,65,7854,416862,7919,9,0
9,6/27/2020,46206,383342,106,10268,0,0,0,0,8053,4311,3443,868,147,12539,429548,12686,4,0
9,6/28/2020,46303,392320,103,10268,0,0,0,0,8053,4316,3448,868,97,8978,438623,9075,5,0
9,6/29/2020,46362,398614,99,10268,0,0,0,0,8053,4320,3451,869,59,6294,444976,6353,4,0
9,6/30/2020,46514,419880,98,10268,0,0,0,0,8053,4322,3453,869,152,21266,466394,21418,2,0
9,7/1/2020,46572,431269,100,10268,0,0,0,0,8053,4324,3457,867,58,11389,477841,11447,2,0
9,7/2/2020,46646,442560,101,10411,0,0,0,0,8210,4326,3459,867,74,11291,489206,11365,2,143
9,7/3/2020,46717,452952,95,10411,0,0,0,0,8210,4335,3463,872,71,10392,499669,10463,9,0
9,7/4/2020,46717,452952,95,10411,0,0,0,0,8210,4335,3463,872,0,0,499669,0,0,0
9,7/5/2020,46717,452952,95,10411,0,0,0,0,8210,4335,3463,872,0,0,499669,0,0,0
9,7/6/2020,46976,477388,69,10411,0,0,0,0,8210,4338,3466,872,259,24436,524364,24695,3,0
9,7/7/2020,47033,483074,83,10411,0,0,0,0,8210,4338,3466,872,57,5686,530107,5743,0,0
9,7/8/2020,47108,490336,88,10411,0,0,0,0,8210,4343,3471,872,75,7262,537444,7337,5,0
9,7/9/2020,47209,498412,90,10552,0,0,0,0,8351,4348,3476,872,101,8076,545621,8177,5,141
9,7/10/2020,47287,510922,77,10552,0,0,0,0,8351,4348,3476,871,78,12510,558209,12588,0,0
9,7/11/2020,47287,510922,77,10552,0,0,0,0,8351,4348,3476,871,0,0,558209,0,0,0
9,7/12/2020,47287,510922,77,10552,0,0,0,0,8351,4348,3476,871,0,0,558209,0,0,0
9,7/13/2020,47510,541808,74,10552,0,0,0,0,8351,4371,3492,879,223,30886,589318,31109,23,0
9,7/14/2020,47530,544231,66,10552,0,0,0,0,8351,4372,3497,875,20,2423,591761,2443,1,0
9,7/15/2020,47636,556463,67,10552,0,0,0,0,8351,4380,3505,875,106,12232,604099,12338,8,0
9,7/16/2020,47750,567798,66,10654,0,0,0,0,8466,4389,3515,874,114,11335,615548,11449,9,102
9,7/17/2020,47893,582076,66,10654,0,0,0,0,8466,4396,3519,877,143,14278,629969,14421,7,0
12,3/4/2020,2,24,0,0,0,0,0,0,0,0,0,0,0,0,26,0,0,0
12,3/5/2020,9,31,0,0,0,0,0,0,0,0,0,0,7,7,40,14,0,0
12,3/6/2020,9,55,0,0,0,0,0,0,0,0,0,0,0,24,64,24,0,0
12,3/7/2020,14,100,0,0,0,0,0,0,0,0,0,0,5,45,114,50,0,0
12,3/8/2020,17,118,0,0,0,0,0,0,0,0,0,0,3,18,135,21,0,0
12,3/9/2020,18,140,0,0,0,0,0,0,0,0,0,0,1,22,158,23,0,0
12,3/10/2020,19,222,0,0,0,0,0,0,0,0,0,0,1,82,241,83,0,0
12,3/11/2020,28,301,0,0,0,0,0,0,0,2,0,0,9,79,329,88,2,0
12,3/12/2020,32,301,0,0,0,0,0,0,0,2,0,0,4,0,333,4,0,0
12,3/13/2020,50,478,0,0,0,0,0,0,0,2,0,0,18,177,528,195,0,0
12,3/14/2020,77,478,0,0,0,0,0,0,0,3,0,0,27,0,555,27,1,0
12,3/15/2020,116,678,0,0,0,0,0,0,0,4,0,0,39,200,794,239,1,0
12,3/16/2020,141,684,0,0,0,0,0,0,0,4,0,0,25,6,825,31,0,0
12,3/17/2020,186,940,0,0,0,0,0,0,0,6,0,0,45,256,1126,301,2,0
12,3/18/2020,314,1225,0,0,0,0,0,0,0,7,0,0,128,285,1539,413,1,0
12,3/19/2020,390,1533,0,0,0,0,0,0,0,8,0,0,76,308,1923,384,1,0
12,3/20/2020,520,1870,0,0,0,0,0,0,0,10,0,0,130,337,2390,467,2,0
12,3/21/2020,658,6579,0,158,0,0,0,0,0,12,0,0,138,4709,7237,4847,2,158
12,3/22/2020,830,7990,0,185,0,0,0,0,0,13,0,0,172,1411,8820,1583,1,27
12,3/23/2020,1171,11063,0,217,0,0,0,0,0,14,0,0,341,3073,12234,3414,1,32
12,3/24/2020,1412,13127,0,259,0,0,0,0,0,18,0,0,241,2064,14539,2305,4,42
12,3/25/2020,1682,15374,0,316,0,0,0,0,0,22,0,0,270,2247,17056,2517,4,57
12,3/26/2020,2355,23741,0,406,0,0,0,0,0,28,0,0,673,8367,26096,9040,6,90
12,3/27/2020,2765,28186,0,456,0,0,0,0,0,34,0,0,410,4445,30951,4855,6,50
12,3/28/2020,3763,35366,0,526,0,0,0,0,0,54,0,0,998,7180,39129,8178,20,70
12,3/29/2020,4246,39070,0,594,0,0,0,0,0,56,0,0,483,3704,43316,4187,2,68
12,3/30/2020,5473,48225,0,652,0,0,0,0,0,63,0,0,1227,9155,53698,10382,7,58
12,3/31/2020,6338,54285,0,823,0,0,0,0,0,77,0,0,865,6060,60623,6925,14,171
12,4/1/2020,6955,59529,0,949,0,0,0,0,0,87,0,0,617,5244,66484,5861,10,126
12,4/2/2020,8010,69286,0,1123,0,0,0,0,0,128,0,0,1055,9757,77296,10812,41,174
12,4/3/2020,9585,82137,0,1287,0,0,0,0,0,163,0,0,1575,12851,91722,14426,35,164
12,4/4/2020,11111,90956,0,1462,0,0,0,0,0,191,0,0,1526,8819,102067,10345,28,175
12,4/5/2020,12151,101253,0,1572,0,0,0,0,0,218,0,0,1040,10297,113404,11337,27,110
12,4/6/2020,13324,109950,0,1682,0,0,0,0,0,236,0,0,1173,8697,123274,9870,18,110
12,4/7/2020,14747,123415,0,1999,0,0,0,0,0,296,0,0,1423,13465,138162,14888,60,317
12,4/8/2020,15455,127679,0,2062,0,0,0,0,0,309,0,0,708,4264,143134,4972,13,63
12,4/9/2020,16364,136185,0,2268,0,0,0,0,0,354,0,0,909,8506,152549,9415,45,206
12,4/10/2020,17531,145299,0,2487,0,0,0,0,0,390,0,0,1167,9114,162830,10281,36,219
12,4/11/2020,18494,154439,0,2661,0,0,0,0,0,438,0,0,963,9140,172933,10103,48,174
12,4/12/2020,19355,163398,0,2772,0,0,0,0,0,465,0,0,861,8959,182753,9820,27,111
12,4/13/2020,20601,175606,0,2833,0,0,0,0,0,483,0,0,1246,12208,196207,13454,18,61
12,4/14/2020,21367,181813,0,3060,0,0,0,0,0,537,0,0,766,6207,203180,6973,54,227
12,4/15/2020,22511,190998,0,3344,0,0,0,0,0,609,0,0,1144,9185,213509,10329,72,284
12,4/16/2020,22897,196351,0,3460,0,0,0,0,0,646,0,0,386,5353,219248,5739,37,116
12,4/17/2020,24119,210718,0,3665,0,0,0,0,0,699,0,0,1222,14367,234837,15589,53,205
12,4/18/2020,25269,221258,0,3842,0,0,0,0,0,754,0,0,1150,10540,246527,11690,55,177
12,4/19/2020,25996,230083,0,3930,0,0,0,0,0,781,0,0,727,8825,256079,9552,27,88
12,4/20/2020,26660,239565,0,4010,0,0,0,0,0,806,0,0,664,9482,266225,10146,25,80
12,4/21/2020,27495,249564,0,4235,0,0,0,0,0,856,0,0,835,9999,277059,10834,50,225
12,4/22/2020,28309,260318,0,4469,0,0,0,0,0,910,0,0,814,10754,288627,11568,54,234
12,4/23/2020,28832,267876,0,4693,0,0,0,0,0,979,0,0,523,7558,296708,8081,69,224
12,4/24/2020,30174,286785,0,4888,0,0,0,0,0,1031,0,0,1342,18909,316959,20251,52,195
12,4/25/2020,30839,302260,0,5045,0,0,0,0,0,1075,0,0,665,15475,333099,16140,44,157
12,4/26/2020,31528,313085,0,5155,0,0,0,0,0,1094,0,0,689,10825,344613,11514,19,110
12,4/27/2020,32138,324325,0,5211,0,0,0,0,0,1101,0,0,610,11240,356463,11850,7,56
12,4/28/2020,32846,334029,0,5266,0,0,0,0,0,1154,0,0,708,9704,366875,10412,53,55
12,4/29/2020,33193,340295,0,5624,0,0,0,0,0,1240,0,0,347,6266,373488,6613,86,358
12,4/30/2020,33690,348715,0,5795,0,0,0,0,0,1290,0,0,497,8420,382405,8917,50,171
12,5/1/2020,34728,367971,0,5795,0,0,0,0,0,1314,0,0,1038,19256,402699,20294,24,0
12,5/2/2020,35463,380549,0,5945,0,0,0,0,0,1388,0,0,735,12578,416012,13313,74,150
12,5/3/2020,36078,392111,0,6244,0,0,0,0,0,1403,0,0,615,11562,428189,12177,15,299
12,5/4/2020,36897,407373,0,6329,0,0,0,0,0,1423,0,0,819,15262,444270,16081,20,85
12,5/5/2020,37439,428252,0,6546,0,0,0,0,0,1536,0,0,542,20879,465691,21421,113,217
12,5/6/2020,38002,442049,0,6776,0,0,0,0,0,1605,0,0,563,13797,480051,14360,69,230
12,5/7/2020,38828,454122,0,6990,0,0,0,0,0,1667,0,0,826,12073,492950,12899,62,214
12,5/8/2020,39199,474142,0,7157,0,0,0,0,0,1738,0,0,371,20020,513341,20391,71,167
12,5/9/2020,40001,487730,0,7325,0,0,0,0,0,1785,0,0,802,13588,527731,14390,47,168
12,5/10/2020,40596,498352,0,7404,0,0,0,0,0,1791,0,0,595,10622,538948,11217,6,79
12,5/11/2020,40982,520075,0,7458,0,0,0,0,0,1805,0,0,386,21723,561057,22109,14,54
12,5/12/2020,41923,537681,0,7654,0,0,0,0,0,1849,1849,0,941,17606,579604,18547,44,196
12,5/13/2020,42402,552361,0,7835,0,0,0,0,0,1898,1898,0,479,14680,594763,15159,49,181
12,5/14/2020,43210,565627,0,7993,0,0,0,0,0,1948,1948,0,808,13266,608837,14074,50,158
12,5/15/2020,43210,565627,0,7993,0,0,0,0,0,1991,1991,0,0,0,608837,0,43,0
12,5/16/2020,44811,585236,0,8393,0,0,0,0,0,2040,2040,0,1601,19609,630047,21210,49,400
12,5/17/2020,45588,606204,0,8478,0,0,0,0,0,2049,2049,0,777,20968,651792,21745,9,85
12,5/18/2020,46442,629970,0,8553,0,0,0,0,0,2073,2073,0,854,23766,676412,24620,24,75
12,5/19/2020,46944,668911,0,8744,0,0,0,0,0,2129,2129,0,502,38941,715855,39443,56,191
12,5/20/2020,47471,723877,0,8934,0,0,0,0,0,2173,2173,0,527,54966,771348,55493,44,190
12,5/21/2020,48675,765254,0,9200,0,0,0,0,0,2222,2222,0,1204,41377,813929,42581,49,266
12,5/22/2020,49451,786045,0,9372,0,0,0,0,0,2268,2268,0,776,20791,835496,21567,46,172
12,5/23/2020,50127,806310,0,9567,0,0,0,0,0,2312,2312,0,676,20265,856437,20941,44,195
12,5/24/2020,50867,820368,0,9638,0,0,0,0,0,2316,2316,0,740,14058,871235,14798,4,71
12,5/25/2020,51746,856489,0,9681,0,0,0,0,0,2331,2331,0,879,36121,908235,37000,15,43
12,5/26/2020,52255,870969,0,9740,0,0,0,0,0,2338,2338,0,509,14480,923224,14989,7,59
12,5/27/2020,52634,880937,0,9899,0,0,0,0,0,2400,2400,0,379,9968,933571,10347,62,159
12,5/28/2020,53285,898331,0,10056,0,0,0,0,0,2446,2446,0,651,17394,951616,18045,46,157
12,5/29/2020,54497,928742,0,10243,0,0,0,0,0,2495,2495,0,1212,30411,983239,31623,49,187
12,5/30/2020,55424,939544,0,10375,0,0,0,0,0,2530,2530,0,927,10802,994968,11729,35,132
12,5/31/2020,56163,965186,0,10453,0,0,0,0,0,2534,2534,0,739,25642,1021349,26381,4,78
12,6/1/2020,56830,983570,0,10494,0,0,0,0,0,2543,2543,0,667,18384,1040400,19051,9,41
12,6/2/2020,57447,992305,0,10678,0,0,0,0,0,2613,2613,0,617,8735,1049752,9352,70,184
12,6/3/2020,58764,1022149,0,10796,0,0,0,0,0,2650,2650,0,1317,29844,1080913,31161,37,118
12,6/4/2020,60183,1046860,0,10923,0,0,0,0,0,2691,2691,0,1419,24711,1107043,26130,41,127
12,6/5/2020,61488,1073452,0,11066,0,0,0,0,0,2745,2745,0,1305,26592,1134940,27897,54,143
12,6/6/2020,62758,1111427,0,11163,0,0,0,0,0,2773,2773,0,1270,37975,1174185,39245,28,97
12,6/7/2020,63938,1152220,0,11215,0,0,0,0,0,2786,2786,0,1180,40793,1216158,41973,13,52
12,6/8/2020,64904,1169646,0,11282,0,0,0,0,0,2798,2798,0,966,17426,1234550,18392,12,67
12,6/9/2020,66000,1192305,0,11460,0,0,0,0,0,2851,2851,0,1096,22659,1258305,23755,53,178
12,6/10/2020,67371,1211652,0,11621,0,0,0,0,0,2889,2889,0,1371,19347,1279023,20718,38,161
12,6/11/2020,69069,1237679,0,11850,0,0,0,0,0,2938,2938,0,1698,26027,1306748,27725,49,229
12,6/12/2020,70971,1264928,0,11986,0,0,0,0,0,2967,2967,0,1902,27249,1335899,29151,29,136
12,6/13/2020,73552,1296861,0,12155,0,0,0,0,0,3016,3016,0,2581,31933,1370413,34514,49,169
12,6/14/2020,75568,1333447,0,12224,0,0,0,0,0,3022,3022,0,2016,36586,1409015,38602,6,69
12,6/15/2020,77326,1352858,0,12298,0,0,0,0,0,3030,3030,0,1758,19411,1430184,21169,8,74
12,6/16/2020,80109,1380200,0,12489,0,0,0,0,0,3085,3085,0,2783,27342,1460309,30125,55,191
12,6/17/2020,82719,1403040,0,12673,0,0,0,0,0,3110,3110,0,2610,22840,1485759,25450,25,184
12,6/18/2020,85926,1425386,0,12862,0,0,0,0,0,3154,3154,0,3207,22346,1511312,25553,44,189
12,6/19/2020,89748,1443123,0,13062,0,0,0,0,0,3197,3197,0,3822,17737,1532871,21559,43,200
12,6/20/2020,93797,1467475,0,13227,0,0,0,0,0,3237,3237,0,4049,24352,1561272,28401,40,165
12,6/21/2020,97291,1502005,0,13325,0,0,0,0,0,3254,3254,0,3494,34530,1599296,38024,17,98
12,6/22/2020,100217,1517270,0,13407,0,0,0,0,0,3266,3266,0,2926,15265,1617487,18191,12,82
12,6/23/2020,103503,1537249,0,13614,0,0,0,0,0,3333,3333,0,3286,19979,1640752,23265,67,207
12,6/24/2020,109014,1559328,0,13865,0,0,0,0,0,3377,3377,0,5511,22079,1668342,27590,44,251
12,6/25/2020,114018,1606626,0,14068,0,0,0,0,0,3423,3423,0,5004,47298,1720644,52302,46,203
12,6/26/2020,122960,1645925,0,14281,0,0,0,0,0,3464,3464,0,8942,39299,1768885,48241,41,213
12,6/27/2020,132545,1696980,0,14432,0,0,0,0,0,3489,3489,0,9585,51055,1829525,60640,25,151
12,6/28/2020,141075,1740822,0,14540,0,0,0,0,0,3518,3518,0,8530,43842,1881897,52372,29,108
12,6/29/2020,146341,1766402,0,14651,0,0,0,0,0,3546,3546,0,5266,25580,1912743,30846,28,111
12,6/30/2020,152434,1792561,0,14879,0,0,0,0,0,3604,3604,0,6093,26159,1944995,32252,58,228
12,7/1/2020,158997,1821357,0,15125,0,0,0,0,0,3650,3650,0,6563,28796,1980354,35359,46,246
12,7/2/2020,169106,1863077,0,15454,0,0,0,0,0,3718,3718,0,10109,41720,2032183,51829,68,329
12,7/3/2020,178594,1902766,0,15795,0,0,0,0,0,3785,3785,0,9488,39689,2081360,49177,67,341
12,7/4/2020,190052,1956445,0,16040,0,0,0,0,0,3803,3803,0,11458,53679,2146497,65137,18,245
12,7/5/2020,200111,2000088,0,16201,0,0,0,0,0,3832,3832,0,10059,43643,2200199,53702,29,161
12,7/6/2020,206447,2027493,0,16352,0,0,0,0,0,3880,3880,0,6336,27405,2233940,33741,48,151
12,7/7/2020,213794,2055400,0,16733,0,0,0,0,0,3943,3943,0,7347,27907,2269194,35254,63,381
12,7/8/2020,223783,2096424,0,17068,0,0,0,0,0,3991,3991,0,9989,41024,2320207,51013,48,335
12,7/9/2020,232718,2124680,0,17479,0,0,0,0,0,4111,4111,0,8935,28256,2357398,37191,120,411
12,7/10/2020,244151,2177476,6974,17916,0,0,0,0,0,4203,4203,0,11433,52796,2421627,64229,92,437
12,7/11/2020,254511,2220788,7186,18341,0,0,0,0,0,4301,4301,0,10360,43312,2475299,53672,98,425
12,7/12/2020,269811,2304196,7542,18590,0,0,0,0,0,4346,4346,0,15300,83408,2574007,98708,45,249
12,7/13/2020,282435,2357139,8051,18817,0,0,0,0,0,4381,4381,0,12624,52943,2639574,65567,35,227
12,7/14/2020,291629,2393614,8354,19201,0,0,0,0,0,4514,4514,0,9194,36475,2685243,45669,133,384
12,7/15/2020,301810,2434143,8217,19659,0,0,0,0,0,4626,4626,0,10181,40529,2735953,50710,112,458
12,7/16/2020,315775,2499843,9112,20154,0,0,0,0,0,4782,4782,0,13965,65700,2815618,79665,156,495
12,7/17/2020,327241,2553527,8961,20526,0,0,0,0,0,4912,4912,0,11466,53684,2880768,65150,130,372
13,3/4/2020,2,0,0,0,0,0,0,0,0,0,0,0,0,0,2,0,0,0
13,3/5/2020,2,0,0,0,0,0,0,0,0,0,0,0,0,0,2,0,0,0
13,3/6/2020,2,0,0,0,0,0,0,0,0,0,0,0,0,0,2,0,0,0
13,3/7/2020,6,0,0,0,0,0,0,0,0,0,0,0,4,0,6,4,0,0
13,3/8/2020,7,0,0,0,0,0,0,0,0,0,0,0,1,0,7,1,0,0
13,3/9/2020,12,0,0,0,0,0,0,0,0,0,0,0,5,0,12,5,0,0
13,3/10/2020,17,0,0,0,0,0,0,0,0,0,0,0,5,0,17,5,0,0
13,3/11/2020,22,0,0,0,0,0,0,0,0,0,0,0,5,0,22,5,0,0
13,3/12/2020,31,0,0,0,0,0,0,0,0,0,0,0,9,0,31,9,0,0
13,3/13/2020,42,0,0,0,0,0,0,0,0,1,0,0,11,0,42,11,1,0
13,3/14/2020,66,0,0,0,0,0,0,0,0,1,0,0,24,0,66,24,0,0
13,3/15/2020,99,0,0,0,0,0,0,0,0,1,0,0,33,0,99,33,0,0
13,3/16/2020,121,0,0,0,0,0,0,0,0,1,0,0,22,0,121,22,0,0
13,3/17/2020,146,0,0,0,0,0,0,0,0,1,0,0,25,0,146,25,0,0
13,3/18/2020,197,1311,0,0,0,0,0,0,0,1,0,0,51,1311,1508,1362,0,0
13,3/19/2020,287,1544,0,0,0,0,0,0,0,10,0,0,90,233,1831,323,9,0
13,3/20/2020,420,1966,0,0,0,0,0,0,0,13,0,0,133,422,2386,555,3,0
13,3/21/2020,507,2557,0,0,0,0,0,0,0,14,0,0,87,591,3064,678,1,0
13,3/22/2020,600,3420,0,0,0,0,0,0,0,23,0,0,93,863,4020,956,9,0
13,3/23/2020,772,4297,0,0,0,0,0,0,0,25,0,0,172,877,5069,1049,2,0
13,3/24/2020,1026,4458,0,0,0,0,0,0,0,32,0,0,254,161,5484,415,7,0
13,3/25/2020,1247,4932,0,394,0,0,0,0,0,40,0,0,221,474,6179,695,8,394
13,3/26/2020,1525,7401,0,473,0,0,0,0,0,48,0,0,278,2469,8926,2747,8,79
13,3/27/2020,2001,7864,0,566,0,0,0,0,0,64,0,0,476,463,9865,939,16,93
13,3/28/2020,2366,8685,0,617,0,0,0,0,0,69,0,0,365,821,11051,1186,5,51
13,3/29/2020,2651,9913,0,666,0,0,0,0,0,80,0,0,285,1228,12564,1513,11,49
13,3/30/2020,2809,9915,0,707,0,0,0,0,0,87,0,0,158,2,12724,160,7,41
13,3/31/2020,3929,12252,0,833,0,0,0,0,0,111,0,0,1120,2337,16181,3457,24,126
13,4/1/2020,4638,15688,0,952,0,0,0,0,0,139,0,0,709,3436,20326,4145,28,119
13,4/2/2020,5348,17609,0,1056,0,0,0,0,0,163,0,0,710,1921,22957,2631,24,104
13,4/3/2020,5831,19434,0,1158,0,0,0,0,0,184,0,0,483,1825,25265,2308,21,102
13,4/4/2020,6160,20134,0,1239,0,0,0,0,0,201,0,0,329,700,26294,1029,17,81
13,4/5/2020,6647,21185,0,1283,0,0,0,0,0,211,0,0,487,1051,27832,1538,10,44
13,4/6/2020,7314,23960,0,1332,0,0,0,0,0,229,0,0,667,2775,31274,3442,18,49
13,4/7/2020,8818,24895,0,1774,0,0,0,0,0,329,0,0,1504,935,33713,2439,100,442
13,4/8/2020,9901,28886,0,1993,0,0,0,0,0,362,0,0,1083,3991,38787,5074,33,219
13,4/9/2020,10566,30519,0,2159,0,0,0,0,0,379,0,0,665,1633,41085,2298,17,166
13,4/10/2020,11483,34664,0,2351,0,0,0,0,0,416,0,0,917,4145,46147,5062,37,192
13,4/11/2020,12159,39556,0,2479,0,0,0,0,0,428,0,0,676,4892,51715,5568,12,128
13,4/12/2020,12452,42001,0,2505,0,0,0,0,0,433,0,0,293,2445,54453,2738,5,26
13,4/13/2020,13315,43706,0,2589,0,0,0,0,0,464,0,0,863,1705,57021,2568,31,84
13,4/14/2020,14223,47572,0,2769,0,0,0,0,0,501,0,0,908,3866,61795,4774,37,180
13,4/15/2020,14987,49103,0,2922,0,0,0,0,0,552,0,0,764,1531,64090,2295,51,153
13,4/16/2020,15669,52270,0,3108,0,0,0,0,0,587,0,0,682,3167,67939,3849,35,186
13,4/17/2020,17194,54490,0,3324,0,0,0,0,0,650,0,0,1525,2220,71684,3745,63,216
13,4/18/2020,17669,56539,0,3420,0,0,0,0,0,673,0,0,475,2049,74208,2524,23,96
13,4/19/2020,18301,61632,0,3464,0,0,0,0,0,687,0,0,632,5093,79933,5725,14,44
13,4/20/2020,18947,65381,0,3550,0,0,0,0,0,733,0,0,646,3749,84328,4395,46,86
13,4/21/2020,19881,68259,0,3779,0,0,0,0,0,799,0,0,934,2878,88140,3812,66,229
13,4/22/2020,20740,73332,0,3959,0,0,0,0,0,836,0,0,859,5073,94072,5932,37,180
13,4/23/2020,21512,79550,0,4069,0,0,0,0,0,872,0,0,772,6218,101062,6990,36,110
13,4/24/2020,22147,85029,0,4221,0,0,0,0,0,892,0,0,635,5479,107176,6114,20,152
13,4/25/2020,22695,96319,0,4326,0,0,0,0,0,904,0,0,548,11290,119014,11838,12,105
13,4/26/2020,23401,99822,0,4359,0,0,0,0,0,912,0,0,706,3503,123223,4209,8,33
13,4/27/2020,23913,103256,0,4681,0,1057,0,0,0,971,0,0,512,3434,127169,3946,59,322
13,4/28/2020,24615,115405,0,4814,0,1087,0,0,0,1026,0,0,702,12149,140020,12851,55,133
13,4/29/2020,25572,118367,0,5056,0,1148,0,0,0,1093,0,0,957,2962,143939,3919,67,242
13,4/30/2020,26155,122889,0,5156,0,1171,0,0,0,1120,0,0,583,4522,149044,5105,27,100
13,5/1/2020,27270,141097,0,5269,0,1215,0,0,0,1154,0,0,1115,18208,168367,19323,34,113
13,5/2/2020,28306,146494,0,5387,0,1247,0,0,0,1174,0,0,1036,5397,174800,6433,20,118
13,5/3/2020,28602,146494,0,5393,0,1249,0,0,0,1177,0,0,296,0,175096,296,3,6
13,5/4/2020,29368,153957,0,5526,0,1284,0,0,0,1222,0,0,766,7463,183325,8229,45,133
13,5/5/2020,29711,171172,0,5634,0,1318,0,0,0,1288,0,0,343,17215,200883,17558,66,108
13,5/6/2020,30696,173441,0,5765,0,1343,0,0,0,1311,0,0,985,2269,204137,3254,23,131
13,5/7/2020,31439,185864,0,5835,0,1374,0,0,0,1336,0,0,743,12423,217303,13166,25,70
13,5/8/2020,32106,195461,0,5935,0,1399,0,0,0,1377,0,0,667,9597,227567,10264,41,100
13,5/9/2020,32532,202792,0,5987,0,1409,0,0,0,1400,0,0,426,7331,235324,7757,23,52
13,5/10/2020,33441,210106,0,5997,0,1412,0,0,0,1405,0,0,909,7314,243547,8223,5,10
13,5/11/2020,33927,217361,0,6015,0,1414,0,0,0,1441,0,0,486,7255,251288,7741,36,18
13,5/12/2020,34635,227544,0,6130,0,1443,0,0,0,1461,0,0,708,10183,262179,10891,20,115
13,5/13/2020,35332,238572,0,6259,0,1494,0,0,0,1505,0,0,697,11028,273904,11725,44,129
13,5/14/2020,35858,250023,0,6345,0,1513,0,0,0,1527,0,0,526,11451,285881,11977,22,86
13,5/15/2020,36681,265193,0,6438,0,1534,0,0,0,1557,0,0,823,15170,301874,15993,30,93
13,5/16/2020,37147,283922,1005,6735,0,1554,0,0,0,1592,0,0,466,18729,321069,19195,35,297
13,5/17/2020,37701,313474,1010,6790,0,1557,0,0,0,1606,0,0,554,29552,351175,30106,14,55
13,5/18/2020,38081,326208,1025,6916,0,1565,0,0,0,1642,0,0,380,12734,364289,13114,36,126
13,5/19/2020,38721,339435,986,7027,0,1589,0,0,0,1664,0,0,640,13227,378156,13867,22,111
13,5/20/2020,39647,363293,959,7107,0,1617,0,0,0,1687,0,0,926,23858,402940,24784,23,80
13,5/21/2020,40405,367326,959,7235,0,1642,0,0,0,1754,0,0,758,4033,407731,4791,67,128
13,5/22/2020,41218,386031,889,7313,0,1658,0,0,0,1785,0,0,813,18705,427249,19518,31,78
13,5/23/2020,42132,411405,848,7411,0,1678,0,0,0,1811,0,0,914,25374,453537,26288,26,98
13,5/24/2020,42838,439116,848,7439,0,1683,0,0,0,1824,0,0,706,27711,481954,28417,13,28
13,5/25/2020,43344,470201,892,7475,0,1686,0,0,0,1830,0,0,506,31085,513545,31591,6,36
13,5/26/2020,43730,471215,854,7547,0,1703,0,0,0,1871,0,0,386,1014,514945,1400,41,72
13,5/27/2020,44421,396335,907,7666,0,1735,0,0,0,1907,0,0,691,-74880,440756,-74189,36,119
13,5/28/2020,45070,399576,903,7767,0,1761,0,0,0,1962,0,0,649,3241,444646,3890,55,101
13,5/29/2020,45670,404601,889,7852,0,1780,0,0,0,1974,0,0,600,5025,450271,5625,12,85
13,5/30/2020,46286,408552,850,7921,0,1790,0,0,0,2003,0,0,616,3951,454838,4567,29,69
13,5/31/2020,46986,418539,853,7946,0,1794,0,0,0,2042,0,0,700,9987,465525,10687,39,25
13,6/1/2020,47618,424013,841,8127,0,1800,0,0,0,2074,0,0,632,5474,471631,6106,32,181
13,6/2/2020,48207,426080,828,8334,0,1821,0,0,0,2102,0,0,589,2067,474287,2656,28,207
13,6/3/2020,48894,433818,815,8419,0,1841,0,0,0,2123,0,0,687,7738,482712,8425,21,85
13,6/4/2020,49847,446484,807,8557,0,1872,0,0,0,2147,0,0,953,12666,496331,13619,24,138
13,6/5/2020,50621,457167,790,8646,0,1897,0,0,0,2174,0,0,774,10683,507788,11457,27,89
13,6/6/2020,51309,471548,788,8662,0,1901,0,0,0,2174,0,0,688,14381,522857,15069,0,16
13,6/7/2020,51898,487986,783,8685,0,1909,0,0,0,2180,0,0,589,16438,539884,17027,6,23
13,6/8/2020,52497,496878,819,8746,0,1925,0,0,0,2208,0,0,599,8892,549375,9491,28,61
13,6/9/2020,53249,503934,834,8872,0,1960,0,0,0,2285,0,0,752,7056,557183,7808,77,126
13,6/10/2020,53980,516975,817,8974,0,1991,0,0,0,2329,0,0,731,13041,570955,13772,44,102
13,6/11/2020,54973,529268,842,9073,0,2006,0,0,0,2375,0,0,993,12293,584241,13286,46,99
13,6/12/2020,55783,536175,836,9181,0,2021,0,0,0,2418,0,0,810,6907,591958,7717,43,108
13,6/13/2020,56801,542879,810,9224,0,2029,0,0,0,2446,0,0,1018,6704,599680,7722,28,43
13,6/14/2020,57681,563109,829,9248,0,2034,0,0,0,2451,0,0,880,20230,620790,21110,5,24
13,6/15/2020,58414,572082,865,9322,0,2043,0,0,0,2494,0,0,733,8973,630496,9706,43,74
13,6/16/2020,59078,575900,875,9454,0,2065,0,0,0,2529,0,0,664,3818,634978,4482,35,132
13,6/17/2020,60030,590437,881,9543,0,2084,0,0,0,2575,0,0,952,14537,650467,15489,46,89
13,6/18/2020,60912,602292,921,9663,0,2109,0,0,0,2605,0,0,882,11855,663204,12737,30,120
13,6/19/2020,62009,608297,937,9772,0,2122,0,0,0,2636,0,0,1097,6005,670306,7102,31,109
13,6/20/2020,63809,630575,944,9837,0,2140,0,0,0,2642,0,0,1800,22278,694384,24078,6,65
13,6/21/2020,64701,633606,944,9837,0,2140,0,0,0,2643,0,0,892,3031,698307,3923,1,0
13,6/22/2020,65928,642098,1000,9953,0,2155,0,0,0,2648,0,0,1227,8492,708026,9719,5,116
13,6/23/2020,67678,663583,1056,10123,0,2174,0,0,0,2688,0,0,1750,21485,731261,23235,40,170
13,6/24/2020,69381,673853,1124,10313,0,2206,0,0,0,2698,0,0,1703,10270,743234,11973,10,190
13,6/25/2020,71095,686829,1135,10457,0,2222,0,0,0,2745,0,0,1714,12976,757924,14690,47,144
13,6/26/2020,72995,698033,1184,10605,0,2244,0,0,0,2770,0,0,1900,11204,771028,13104,25,148
13,6/27/2020,74985,714828,1178,10689,0,2261,0,0,0,2776,0,0,1990,16795,789813,18785,6,84
13,6/28/2020,77210,729728,1236,10711,0,2268,0,0,0,2778,0,0,2225,14900,806938,17125,2,22
13,6/29/2020,79417,743700,1359,10824,0,2289,0,0,0,2784,0,0,2207,13972,823117,16179,6,113
13,6/30/2020,81291,752587,1459,11051,0,2323,0,0,0,2805,0,0,1874,8887,833878,10761,21,227
13,7/1/2020,84237,770801,1570,11275,0,2357,0,0,0,2827,0,0,2946,18214,855038,21160,22,224
13,7/2/2020,87709,795530,1649,11500,0,2389,0,0,0,2849,0,0,3472,24729,883239,28201,22,225
13,7/3/2020,90493,810724,1671,11653,0,2413,0,0,0,2856,0,0,2784,15194,901217,17978,7,153
13,7/4/2020,93319,833040,1726,11743,0,2425,0,0,0,2857,0,0,2826,22316,926359,25142,1,90
13,7/5/2020,95516,853669,1805,11775,0,2429,0,0,0,2860,0,0,2197,20629,949185,22826,3,32
13,7/6/2020,97064,861889,1962,11919,0,2441,0,0,0,2878,0,0,1548,8220,958953,9768,18,144
13,7/7/2020,100470,878982,2096,12226,0,2471,0,0,0,2899,0,0,3406,17093,979452,20499,21,307
13,7/8/2020,103890,896519,2215,12500,0,2502,0,0,0,2922,0,0,3420,17537,1000409,20957,23,274
13,7/9/2020,106727,912695,2322,12606,0,2519,0,0,0,2930,0,0,2837,16176,1019422,19013,8,106
13,7/10/2020,111211,935137,2443,12937,0,2565,0,0,0,2965,0,0,4484,22442,1046348,26926,35,331
13,7/11/2020,114401,950472,2446,13205,0,2610,0,0,0,2996,0,0,3190,15335,1064873,18525,31,268
13,7/12/2020,116926,966490,2512,13259,0,2621,0,0,0,3001,0,0,2525,16018,1083416,18543,5,54
13,7/13/2020,120569,987398,2600,13476,0,2643,0,0,0,3026,0,0,3643,20908,1107967,24551,25,217
13,7/14/2020,123963,1007071,2741,13685,0,2662,0,0,0,3054,0,0,3394,19673,1131034,23067,28,209
13,7/15/2020,127834,1027149,2786,14102,0,2702,0,0,0,3091,0,0,3871,20078,1154983,23949,37,417
13,7/16/2020,131275,1046947,2841,14346,0,2736,0,0,0,3104,0,0,3441,19798,1178222,23239,13,244
13,7/17/2020,135183,1063495,2902,14647,0,2781,0,0,0,3132,0,0,3908,16548,1198678,20456,28,301
16,3/7/2020,0,27,0,0,0,0,0,0,0,0,0,0,0,0,27,0,0,0
16,3/8/2020,0,27,0,0,0,0,0,0,0,0,0,0,0,0,27,0,0,0
16,3/9/2020,0,41,0,0,0,0,0,0,0,0,0,0,0,14,41,14,0,0
16,3/10/2020,0,41,0,0,0,0,0,0,0,0,0,0,0,0,41,0,0,0
16,3/11/2020,0,67,0,0,0,0,0,0,0,0,0,0,0,26,67,26,0,0
16,3/12/2020,0,93,0,0,0,0,0,0,0,0,0,0,0,26,93,26,0,0
16,3/13/2020,0,131,0,0,0,0,0,0,0,0,0,0,0,38,131,38,0,0
16,3/14/2020,2,174,0,0,0,0,0,0,0,0,0,0,2,43,176,45,0,0
16,3/15/2020,5,174,0,0,0,0,0,0,0,0,0,0,3,0,179,3,0,0
16,3/16/2020,5,265,0,0,0,0,0,0,0,0,0,0,0,91,270,91,0,0
16,3/17/2020,7,346,0,0,0,0,0,0,0,0,0,0,2,81,353,83,0,0
16,3/18/2020,9,459,0,0,0,0,0,0,0,0,0,0,2,113,468,115,0,0
16,3/19/2020,11,459,0,0,0,0,0,0,0,0,0,0,2,0,470,2,0,0
16,3/20/2020,23,590,0,0,0,0,0,0,0,0,0,0,12,131,613,143,0,0
16,3/21/2020,31,880,0,0,0,0,0,0,0,0,0,0,8,290,911,298,0,0
16,3/22/2020,42,1175,0,0,0,0,0,0,0,0,0,0,11,295,1217,306,0,0
16,3/23/2020,47,1309,0,0,0,0,0,0,0,0,0,0,5,134,1356,139,0,0
16,3/24/2020,50,1887,0,0,0,0,0,0,0,0,0,0,3,578,1937,581,0,0
16,3/25/2020,73,1887,0,0,0,0,0,0,0,0,0,0,23,0,1960,23,0,0
16,3/26/2020,123,2065,34,0,0,0,0,0,0,0,0,0,50,178,2188,228,0,0
16,3/27/2020,189,2668,31,0,0,0,0,0,0,3,0,0,66,603,2857,669,3,0
16,3/28/2020,230,3342,37,25,0,0,0,0,0,4,0,0,41,674,3572,715,1,25
16,3/29/2020,261,4021,35,36,0,0,0,0,0,5,0,0,31,679,4282,710,1,11
16,3/30/2020,310,4396,42,39,0,0,0,0,0,6,0,0,49,375,4706,424,1,3
16,3/31/2020,415,5297,45,45,0,6,0,0,0,7,0,0,105,901,5712,1006,1,6
16,4/1/2020,525,6076,49,46,0,7,0,0,0,9,0,0,110,779,6601,889,2,1
16,4/2/2020,669,6613,49,49,0,7,0,0,0,9,0,0,144,537,7282,681,0,3
16,4/3/2020,891,7054,45,56,0,7,0,0,0,9,0,0,222,441,7945,663,0,7
16,4/4/2020,1013,7857,53,62,0,8,0,0,0,10,0,0,122,803,8870,925,1,6
16,4/5/2020,1077,9184,51,66,0,11,0,0,0,10,0,0,64,1327,10261,1391,0,4
16,4/6/2020,1101,9894,62,77,0,16,0,0,0,10,0,0,24,710,10995,734,0,11
16,4/7/2020,1170,10076,67,83,0,21,0,0,0,13,0,0,69,182,11246,251,3,6
16,4/8/2020,1210,10688,62,93,0,24,0,0,0,15,0,0,40,612,11898,652,2,10
16,4/9/2020,1232,11299,70,113,0,29,0,0,0,18,0,0,22,611,12531,633,3,20
16,4/10/2020,1353,11741,67,127,0,33,0,0,0,24,0,0,121,442,13094,563,6,14
16,4/11/2020,1396,12368,61,128,0,35,0,0,0,25,0,0,43,627,13764,670,1,1
16,4/12/2020,1407,12901,63,131,0,38,0,0,0,27,0,0,11,533,14308,544,2,3
16,4/13/2020,1426,13455,62,132,0,38,0,0,0,27,0,0,19,554,14881,573,0,1
16,4/14/2020,1453,13661,59,135,0,38,0,0,0,33,0,0,27,206,15114,233,6,3
16,4/15/2020,1464,13934,66,141,0,43,0,0,0,39,0,0,11,273,15398,284,6,6
16,4/16/2020,1587,14655,70,143,0,46,0,0,0,41,0,0,123,721,16242,844,2,2
16,4/17/2020,1609,15043,58,148,0,51,0,0,390,41,0,0,22,388,16652,410,0,5
16,4/18/2020,1655,15292,53,151,0,53,0,0,453,43,0,0,46,249,16947,295,2,3
16,4/19/2020,1668,15773,43,151,0,53,0,0,520,44,0,0,13,481,17441,494,1,0
16,4/20/2020,1672,15773,53,151,0,53,0,0,585,45,0,0,4,0,17445,4,1,0
16,4/21/2020,1736,16071,69,157,0,58,0,0,660,48,0,0,64,298,17807,362,3,6
16,4/22/2020,1766,16404,54,158,0,58,0,0,710,51,0,0,30,333,18170,363,3,1
16,4/23/2020,1802,17370,52,162,0,60,0,0,767,54,0,0,36,966,19172,1002,3,4
16,4/24/2020,1836,17611,31,166,0,63,0,0,822,54,0,0,34,241,19447,275,0,4
16,4/25/2020,1870,17611,35,168,0,71,0,0,867,54,0,0,34,0,19481,34,0,2
16,4/26/2020,1887,17611,38,169,0,72,0,0,938,56,0,0,17,0,19498,17,2,1
16,4/27/2020,1897,18127,36,169,0,71,0,0,983,56,0,0,10,516,20024,526,0,0
16,4/28/2020,1917,18135,41,172,0,73,0,0,1039,58,0,0,20,8,20052,28,2,3
16,4/29/2020,1952,26430,39,173,0,73,0,0,1087,60,0,0,35,8295,28382,8330,2,1
16,4/30/2020,1984,26862,36,175,0,74,0,0,1121,60,0,0,32,432,28846,464,0,2
16,5/1/2020,2015,27210,28,178,0,75,0,0,1175,63,0,0,31,348,29225,379,3,3
16,5/2/2020,2035,27455,23,178,0,76,0,0,1215,63,0,0,20,245,29490,265,0,0
16,5/3/2020,2061,27746,27,200,0,83,0,0,1267,63,0,0,26,291,29807,317,0,22
16,5/4/2020,2061,27746,27,200,0,83,0,0,1267,64,0,0,0,0,29807,0,1,0
16,5/5/2020,2106,28202,27,201,0,83,0,0,1358,64,0,0,45,456,30308,501,0,1
16,5/6/2020,2127,28418,21,203,0,84,0,0,1379,65,0,0,21,216,30545,237,1,2
16,5/7/2020,2158,28732,20,205,0,86,0,0,1399,66,0,0,31,314,30890,345,1,2
16,5/8/2020,2178,29092,16,206,0,86,0,0,1420,67,0,0,20,360,31270,380,1,1
16,5/9/2020,2205,29601,19,206,0,86,0,0,1442,67,0,0,27,509,31806,536,0,0
16,5/10/2020,2230,29912,25,207,0,87,0,0,1473,67,0,0,25,311,32142,336,0,1
16,5/11/2020,2230,29912,30,207,0,87,0,0,1473,67,0,0,0,0,32142,0,0,0
16,5/12/2020,2260,30445,25,210,0,87,0,0,1508,70,0,0,30,533,32705,563,3,3
16,5/13/2020,2293,30835,20,214,0,88,0,0,1536,69,0,0,33,390,33128,423,-1,4
16,5/14/2020,2324,31430,19,212,0,88,0,0,1557,69,0,0,31,595,33754,626,0,-2
16,5/15/2020,2351,32394,26,212,0,89,0,0,1573,72,0,0,27,964,34745,991,3,0
16,5/16/2020,2389,33299,19,213,0,89,0,0,1588,73,0,0,38,905,35688,943,1,1
16,5/17/2020,2419,34253,26,213,0,89,0,0,1612,73,0,0,30,954,36672,984,0,0
16,5/18/2020,2419,34253,30,213,0,89,0,0,1612,73,0,0,0,0,36672,0,0,0
16,5/19/2020,2455,35614,28,213,0,89,0,0,1649,74,0,0,36,1361,38069,1397,1,0
16,5/20/2020,2476,36091,28,215,0,89,0,0,1668,77,0,0,21,477,38567,498,3,2
16,5/21/2020,2506,36382,27,221,0,91,0,0,1688,77,0,0,30,291,38888,321,0,6
16,5/22/2020,2534,37061,19,223,0,92,0,0,1720,77,0,0,28,679,39595,707,0,2
16,5/23/2020,2595,38014,19,225,0,94,0,0,1735,79,59,20,61,953,40609,1014,2,2
16,5/24/2020,2626,38780,23,225,0,94,0,0,1755,79,59,20,31,766,41406,797,0,0
16,5/25/2020,2626,38780,15,225,0,94,0,0,1755,79,59,20,0,0,41406,0,0,0
16,5/26/2020,2626,38780,19,225,0,94,0,0,1755,79,59,20,0,0,41406,0,0,0
16,5/27/2020,2699,40318,24,231,0,95,0,0,2100,81,61,20,73,1538,43017,1611,2,6
16,5/28/2020,2731,41144,30,234,0,95,0,0,2185,82,62,20,32,826,43875,858,1,3
16,5/29/2020,2769,41992,31,238,0,96,0,0,2195,82,62,20,38,848,44761,886,0,4
16,5/30/2020,2803,42621,30,240,0,96,0,0,2225,82,62,20,34,629,45424,663,0,2
16,5/31/2020,2839,43858,29,242,3,96,0,0,2248,82,62,20,36,1237,46697,1273,0,2
16,6/1/2020,2839,43858,25,242,3,96,0,0,2248,82,62,20,0,0,46697,0,0,0
16,6/2/2020,2906,45227,34,247,4,98,0,0,2266,83,63,20,67,1369,48133,1436,1,5
16,6/3/2020,2933,46009,30,251,3,98,0,0,2282,83,63,20,27,782,48942,809,0,4
16,6/4/2020,2990,46815,28,253,3,98,0,0,2311,83,63,20,57,806,49805,863,0,2
16,6/5/2020,3054,50570,29,255,8,98,0,0,2362,83,63,20,64,3755,53624,3819,0,2
16,6/6/2020,3111,52128,21,257,8,98,0,0,2408,83,63,20,57,1558,55239,1615,0,2
16,6/7/2020,3139,52902,30,260,8,99,0,0,2461,83,63,20,28,774,56041,802,0,3
16,6/8/2020,3139,52902,23,260,8,99,0,0,2461,83,63,20,0,0,56041,0,0,0
16,6/9/2020,3189,54488,21,260,7,99,0,0,2509,83,63,20,50,1586,57677,1636,0,0
16,6/10/2020,3220,55832,20,262,7,99,0,0,2554,85,65,20,31,1344,59052,1375,2,2
16,6/11/2020,3260,56855,28,262,7,99,0,0,2628,85,65,20,40,1023,60115,1063,0,0
16,6/12/2020,3302,58130,20,265,5,98,0,0,2684,86,66,20,42,1275,61432,1317,1,3
16,6/13/2020,3353,59305,24,265,5,98,0,0,2776,87,67,20,51,1175,62658,1226,1,0
16,6/14/2020,3399,59581,22,266,6,98,0,0,2837,87,67,20,46,276,62980,322,0,1
16,6/15/2020,3399,59581,23,266,5,98,0,0,2837,87,67,20,0,0,62980,0,0,0
16,6/16/2020,3462,62185,24,270,6,100,0,0,2877,88,68,20,63,2604,65647,2667,1,4
16,6/17/2020,3540,63244,28,275,8,101,0,0,2921,88,68,20,78,1059,66784,1137,0,5
16,6/18/2020,3632,64380,23,275,7,101,0,0,3013,88,68,20,92,1136,68012,1228,0,0
16,6/19/2020,3743,65802,28,278,9,101,0,0,3088,89,69,20,111,1422,69545,1533,1,3
16,6/20/2020,3871,67325,28,279,9,101,0,0,3183,89,69,20,128,1523,71196,1651,0,1
16,6/21/2020,4006,68962,31,283,12,101,0,0,3305,89,69,20,135,1637,72968,1772,0,4
16,6/22/2020,4006,68962,41,283,12,101,0,0,3305,89,69,20,0,0,72968,0,0,0
16,6/23/2020,4254,71910,39,293,14,102,0,0,3405,89,69,20,248,2948,76164,3196,0,10
16,6/24/2020,4402,73433,34,298,14,105,0,0,3484,89,69,20,148,1523,77835,1671,0,5
16,6/25/2020,4645,75894,45,300,14,106,0,0,3610,90,70,20,243,2461,80539,2704,1,2
16,6/26/2020,4865,77505,48,303,20,106,0,0,3712,90,70,20,220,1611,82370,1831,0,3
16,6/27/2020,5148,78908,42,309,19,108,0,0,3827,90,70,20,283,1403,84056,1686,0,6
16,6/28/2020,5319,81026,48,312,18,111,0,0,3898,91,71,20,171,2118,86345,2289,1,3
16,6/29/2020,5319,81026,50,312,17,111,0,0,3898,91,71,20,0,0,86345,0,0,0
16,6/30/2020,5752,83551,60,322,18,114,0,0,4073,91,71,20,433,2525,89303,2958,0,10
16,7/1/2020,6117,84923,75,330,18,116,0,0,4233,92,72,20,365,1372,91040,1737,1,8
16,7/2/2020,6370,88751,69,340,17,118,0,0,4393,92,72,20,253,3828,95121,4081,0,10
16,7/3/2020,6593,92116,64,350,23,121,0,0,2801,92,72,20,223,3365,98709,3588,0,10
16,7/4/2020,6994,94073,67,355,23,121,0,0,2831,93,73,20,401,1957,101067,2358,1,5
16,7/5/2020,7370,96896,71,359,19,122,0,0,2858,93,73,20,376,2823,104266,3199,0,4
16,7/6/2020,7733,98732,85,369,22,124,0,0,2886,93,73,20,363,1836,106465,2199,0,10
16,7/7/2020,8052,100489,105,387,25,130,0,0,2907,94,74,20,319,1757,108541,2076,1,18
16,7/8/2020,8539,102792,118,396,26,130,0,0,2932,94,74,20,487,2303,111331,2790,0,9
16,7/9/2020,8969,105651,120,411,28,133,0,0,2978,98,78,20,430,2859,114620,3289,4,15
16,7/10/2020,9428,108650,124,432,29,137,0,0,3022,100,80,20,459,2999,118078,3458,2,21
16,7/11/2020,9928,112421,122,449,33,138,0,0,3066,101,81,20,500,3771,122349,4271,1,17
16,7/12/2020,10505,114756,140,468,33,139,0,0,3114,102,82,20,577,2335,125261,2912,1,19
16,7/13/2020,10902,116230,153,477,35,142,0,0,3179,102,82,20,397,1474,127132,1871,0,9
16,7/14/2020,11402,118882,153,500,35,144,0,0,3262,102,82,20,500,2652,130284,3152,0,23
16,7/15/2020,11718,122196,153,510,35,151,0,0,3360,103,83,20,316,3314,133914,3630,1,10
16,7/16/2020,12445,124418,153,526,35,151,0,0,3513,110,89,21,727,2222,136863,2949,7,16
16,7/17/2020,13133,127186,153,554,35,165,0,0,3676,114,93,21,688,2768,140319,3456,4,28
15,3/7/2020,1,0,0,0,0,0,0,0,0,0,0,0,0,0,1,0,0,0
15,3/8/2020,1,0,0,0,0,0,0,0,0,0,0,0,0,0,1,0,0,0
15,3/9/2020,2,0,0,0,0,0,0,0,0,0,0,0,1,0,2,1,0,0
15,3/10/2020,2,0,0,0,0,0,0,0,0,0,0,0,0,0,2,0,0,0
15,3/11/2020,2,0,0,0,0,0,0,0,0,0,0,0,0,0,2,0,0,0
15,3/12/2020,2,0,0,0,0,0,0,0,0,0,0,0,0,0,2,0,0,0
15,3/13/2020,2,0,0,0,0,0,0,0,0,0,0,0,0,0,2,0,0,0
15,3/14/2020,2,0,0,0,0,0,0,0,0,0,0,0,0,0,2,0,0,0
15,3/15/2020,2,0,0,0,0,0,0,0,0,0,0,0,0,0,2,0,0,0
15,3/16/2020,7,0,0,0,0,0,0,0,0,0,0,0,5,0,7,5,0,0
15,3/17/2020,10,0,0,0,0,0,0,0,0,0,0,0,3,0,10,3,0,0
15,3/18/2020,14,93,0,0,0,0,0,0,0,0,0,0,4,93,107,97,0,0
15,3/19/2020,16,93,0,0,0,0,0,0,0,0,0,0,2,0,109,2,0,0
15,3/20/2020,26,124,0,0,0,0,0,0,0,0,0,0,10,31,150,41,0,0
15,3/21/2020,37,124,0,0,0,0,0,0,0,0,0,0,11,0,161,11,0,0
15,3/22/2020,48,263,0,0,0,0,0,0,0,0,0,0,11,139,311,150,0,0
15,3/23/2020,56,2955,0,0,0,0,0,0,0,0,0,0,8,2692,3011,2700,0,0
15,3/24/2020,77,3589,0,4,0,0,0,0,0,0,0,0,21,634,3666,655,0,4
15,3/25/2020,90,4357,0,6,0,0,0,0,0,0,0,0,13,768,4447,781,0,2
15,3/26/2020,95,4357,0,5,0,0,0,0,0,0,0,0,5,0,4452,5,0,-1
15,3/27/2020,106,4357,0,7,0,0,0,0,0,0,0,0,11,0,4463,11,0,2
15,3/28/2020,120,4357,0,8,0,0,0,0,0,0,0,0,14,0,4477,14,0,1
15,3/29/2020,151,6849,0,12,0,0,0,0,0,0,0,0,31,2492,7000,2523,0,4
15,3/30/2020,175,7825,0,12,0,0,0,0,0,0,0,0,24,976,8000,1000,0,0
15,3/31/2020,204,8471,0,12,0,6,0,0,49,0,0,0,29,646,8675,675,0,0
15,4/1/2020,208,8721,0,13,0,6,0,0,58,1,0,0,4,250,8929,254,1,1
15,4/2/2020,258,10206,0,15,0,6,0,0,69,1,0,0,50,1485,10464,1535,0,2
15,4/3/2020,285,10206,0,15,0,6,0,0,72,2,0,0,27,0,10491,27,1,0
15,4/4/2020,319,11959,0,18,0,6,0,0,78,3,0,0,34,1753,12278,1787,1,3
15,4/5/2020,351,12604,0,19,0,6,0,0,82,4,0,0,32,645,12955,677,1,1
15,4/6/2020,371,13155,0,21,0,6,0,0,85,4,0,0,20,551,13526,571,0,2
15,4/7/2020,387,13155,0,26,0,6,0,0,89,5,0,0,16,0,13542,16,1,5
15,4/8/2020,410,14739,0,42,0,6,0,0,113,5,0,0,23,1584,15149,1607,0,16
15,4/9/2020,435,15316,0,42,0,6,0,0,113,5,0,0,25,577,15751,602,0,0
15,4/10/2020,442,15707,0,42,0,6,0,2,251,6,0,0,7,391,16149,398,1,0
15,4/11/2020,465,17066,0,43,0,6,0,2,284,8,0,0,23,1359,17531,1382,2,1
15,4/12/2020,486,17482,0,44,0,6,0,2,300,8,0,0,21,416,17968,437,0,1
15,4/13/2020,499,18345,0,44,0,6,0,2,310,9,0,0,13,863,18844,876,1,0
15,4/14/2020,504,18916,0,44,0,0,0,0,315,9,0,0,5,571,19420,576,0,0
15,4/15/2020,517,19286,0,45,0,0,0,0,333,9,0,0,13,370,19803,383,0,1
15,4/16/2020,530,20170,0,45,0,0,0,0,359,9,0,0,13,884,20700,897,0,0
15,4/17/2020,541,21316,0,45,0,0,0,0,374,9,0,0,11,1146,21857,1157,0,0
15,4/18/2020,553,21790,0,48,0,0,0,0,390,9,0,0,12,474,22343,486,0,3
15,4/19/2020,574,22896,0,51,0,0,0,0,410,9,0,0,21,1106,23470,1127,0,3
15,4/20/2020,580,23595,0,52,0,0,0,0,414,10,0,0,6,699,24175,705,1,1
15,4/21/2020,584,24112,0,55,0,0,0,0,423,10,0,0,4,517,24696,521,0,3
15,4/22/2020,582,24760,0,56,0,0,0,0,437,12,0,0,-2,648,25342,646,2,1
15,4/23/2020,592,25536,0,63,0,0,0,0,444,12,0,0,10,776,26128,786,0,7
15,4/24/2020,596,26291,0,63,0,0,0,0,455,12,0,0,4,755,26887,759,0,0
15,4/25/2020,601,27439,0,67,0,0,0,0,463,13,0,0,5,1148,28040,1153,1,4
15,4/26/2020,603,27880,0,68,0,0,0,0,482,14,0,0,2,441,28483,443,1,1
15,4/27/2020,606,28404,0,68,0,0,0,0,488,14,0,0,3,524,29010,527,0,0
15,4/28/2020,607,28576,0,68,0,0,0,0,493,16,0,0,1,172,29183,173,2,0
15,4/29/2020,609,29009,0,69,0,0,0,0,505,16,0,0,2,433,29618,435,0,1
15,4/30/2020,613,30027,0,69,0,0,0,0,516,16,0,0,4,1018,30640,1022,0,0
15,5/1/2020,618,30476,0,70,0,0,0,0,526,16,0,0,5,449,31094,454,0,1
15,5/2/2020,619,31366,0,72,0,0,0,0,532,16,0,0,1,890,31985,891,0,2
15,5/3/2020,620,32330,0,72,0,0,0,0,541,16,0,0,1,964,32950,965,0,0
15,5/4/2020,620,33246,0,73,0,0,0,0,544,17,0,0,0,916,33866,916,1,1
15,5/5/2020,621,33378,0,73,0,0,0,0,548,17,0,0,1,132,33999,133,0,0
15,5/6/2020,625,34574,0,73,0,0,0,0,551,17,0,0,4,1196,35199,1200,0,0
15,5/7/2020,626,34915,0,74,0,0,0,0,558,17,0,0,1,341,35541,342,0,1
15,5/8/2020,629,35989,0,74,0,0,0,0,565,17,0,0,3,1074,36618,1077,0,0
15,5/9/2020,629,35633,0,81,0,0,0,0,566,17,0,0,0,-356,36262,-356,0,7
15,5/10/2020,631,36639,0,81,0,0,0,0,551,17,0,0,2,1006,37270,1008,0,0
15,5/11/2020,632,37051,0,81,0,0,0,0,561,17,0,0,1,412,37683,413,0,0
15,5/12/2020,634,37305,0,81,0,0,0,0,561,17,0,0,2,254,37939,256,0,0
15,5/13/2020,635,37730,0,81,0,0,0,0,563,17,0,0,1,425,38365,426,0,0
15,5/14/2020,638,38243,0,81,0,0,0,0,563,17,0,0,3,513,38881,516,0,0
15,5/15/2020,637,38139,0,81,0,0,0,0,564,17,0,0,-1,-104,38776,-105,0,0
15,5/16/2020,638,40245,0,81,0,0,0,0,565,17,0,0,1,2106,40883,2107,0,0
15,5/17/2020,639,41035,0,82,0,0,0,0,572,17,0,0,1,790,41674,791,0,1
15,5/18/2020,640,41405,0,82,0,0,0,0,573,17,0,0,1,370,42045,371,0,0
15,5/19/2020,640,44383,0,82,0,0,0,0,574,17,0,0,0,2978,45023,2978,0,0
15,5/20/2020,641,45663,0,82,0,0,0,0,578,17,0,0,1,1280,46304,1281,0,0
15,5/21/2020,643,46506,0,82,0,0,0,0,578,17,0,0,2,843,47149,845,0,0
15,5/22/2020,647,47338,0,83,0,0,0,0,579,17,0,0,4,832,47985,836,0,1
15,5/23/2020,642,48179,0,84,0,0,0,0,585,17,0,0,-5,841,48821,836,0,1
15,5/24/2020,643,48929,0,84,0,0,0,0,589,17,0,0,1,750,49572,751,0,0
15,5/25/2020,643,49728,0,84,0,0,0,0,591,17,0,0,0,799,50371,799,0,0
15,5/26/2020,643,49728,0,84,0,0,0,0,592,17,0,0,0,0,50371,0,0,0
15,5/27/2020,643,50559,0,83,0,0,0,0,593,17,0,0,0,831,51202,831,0,-1
15,5/28/2020,644,51195,0,83,0,0,0,0,600,17,0,0,1,636,51839,637,0,0
15,5/29/2020,647,52177,0,83,0,0,0,0,604,17,0,0,3,982,52824,985,0,0
15,5/30/2020,649,53365,0,83,0,0,0,0,605,17,0,0,2,1188,54014,1190,0,0
15,5/31/2020,651,53969,0,83,0,0,0,0,606,17,0,0,2,604,54620,606,0,0
15,6/1/2020,652,47835,0,83,0,0,0,0,608,17,0,0,1,-6134,48487,-6133,0,0
15,6/2/2020,652,48269,0,83,0,0,0,0,608,17,0,0,0,434,48921,434,0,0
15,6/3/2020,653,48855,0,83,0,0,0,0,609,17,0,0,1,586,49508,587,0,0
15,6/4/2020,653,49985,0,83,0,0,0,0,612,17,0,0,0,1130,50638,1130,0,0
15,6/5/2020,655,51681,0,83,0,0,0,0,611,17,0,0,2,1696,52336,1698,0,0
15,6/6/2020,664,52593,0,83,0,0,0,0,614,17,0,0,9,912,53257,921,0,0
15,6/7/2020,673,53382,0,83,0,0,0,0,616,17,0,0,9,789,54055,798,0,0
15,6/8/2020,675,54472,0,84,0,0,0,0,617,17,0,0,2,1090,55147,1092,0,1
15,6/9/2020,676,54798,0,84,0,0,0,0,618,17,0,0,1,326,55474,327,0,0
15,6/10/2020,682,55491,0,84,0,0,0,0,621,17,0,0,6,693,56173,699,0,0
15,6/11/2020,685,56610,0,85,0,0,0,0,622,17,0,0,3,1119,57295,1122,0,1
15,6/12/2020,692,57887,0,86,0,0,0,0,623,17,0,0,7,1277,58579,1284,0,1
15,6/13/2020,706,58632,0,87,0,0,0,0,627,17,0,0,14,745,59338,759,0,1
15,6/14/2020,723,59599,0,89,0,0,0,0,628,17,0,0,17,967,60322,984,0,2
15,6/15/2020,728,60746,0,91,0,0,0,0,629,17,0,0,5,1147,61474,1152,0,2
15,6/16/2020,736,61292,0,91,0,0,0,0,630,17,0,0,8,546,62028,554,0,0
15,6/17/2020,740,62503,0,92,0,0,0,0,637,17,0,0,4,1211,63243,1215,0,1
15,6/18/2020,744,63630,0,95,0,0,0,0,639,17,0,0,4,1127,64374,1131,0,3
15,6/19/2020,762,64982,0,95,0,0,0,0,640,17,0,0,18,1352,65744,1370,0,0
15,6/20/2020,789,65945,0,96,0,0,0,0,642,17,0,0,27,963,66734,990,0,1
15,6/21/2020,803,67057,0,96,0,0,0,0,644,17,0,0,14,1112,67860,1126,0,0
15,6/22/2020,814,67897,0,97,0,0,0,0,651,17,0,0,11,840,68711,851,0,1
15,6/23/2020,816,68524,0,99,0,0,0,0,669,17,0,0,2,627,69340,629,0,2
15,6/24/2020,819,69720,0,104,0,0,0,0,673,17,0,0,3,1196,70539,1199,0,5
15,6/25/2020,835,71100,0,105,0,0,0,0,686,17,0,0,16,1380,71935,1396,0,1
15,6/26/2020,850,72155,0,109,0,0,0,0,696,17,0,0,15,1055,73005,1070,0,4
15,6/27/2020,866,73435,0,109,0,0,0,0,705,17,0,0,16,1280,74301,1296,0,0
15,6/28/2020,872,74606,0,110,0,0,0,0,714,18,0,0,6,1171,75478,1177,1,1
15,6/29/2020,899,76256,0,111,0,0,0,0,719,18,0,0,27,1650,77155,1677,0,1
15,6/30/2020,900,76843,0,111,0,0,0,0,722,18,0,0,1,587,77743,588,0,0
15,7/1/2020,917,78141,0,113,0,0,0,0,736,18,0,0,17,1298,79058,1315,0,2
15,7/2/2020,926,79364,0,116,0,0,0,0,741,18,0,0,9,1223,80290,1232,0,3
15,7/3/2020,946,80672,0,116,0,0,0,0,746,18,0,0,20,1308,81618,1328,0,0
15,7/4/2020,975,82501,0,118,0,0,0,0,754,19,0,0,29,1829,83476,1858,1,2
15,7/5/2020,999,83326,0,118,0,0,0,0,756,19,0,0,24,825,84325,849,0,0
15,7/6/2020,1023,84035,0,118,0,0,0,0,777,19,0,0,24,709,85058,733,0,0
15,7/7/2020,1030,84643,0,119,0,0,0,0,781,19,0,0,7,608,85673,615,0,1
15,7/8/2020,1071,86025,0,119,0,0,0,0,797,19,0,0,41,1382,87096,1423,0,0
15,7/9/2020,1094,88058,0,122,0,0,0,0,811,19,0,0,23,2033,89152,2056,0,3
15,7/10/2020,1130,89465,0,123,0,0,0,0,840,19,0,0,36,1407,90595,1443,0,1
15,7/11/2020,1158,91076,0,125,0,0,0,0,847,19,0,0,28,1611,92234,1639,0,2
15,7/12/2020,1200,92720,0,125,0,0,0,0,872,19,0,0,42,1644,93920,1686,0,0
15,7/13/2020,1220,93950,0,125,0,0,0,0,890,19,0,0,20,1230,95170,1250,0,0
15,7/14/2020,1243,94827,0,128,0,0,0,0,911,22,0,0,23,877,96070,900,3,3
15,7/15/2020,1264,96293,0,133,0,0,0,0,921,22,0,0,21,1466,97557,1487,0,5
15,7/16/2020,1292,98095,0,137,0,0,0,0,951,22,0,0,28,1802,99387,1830,0,4
15,7/17/2020,1311,99893,0,138,0,0,0,0,975,22,0,0,19,1798,101204,1817,0,1
17,3/4/2020,4,124,0,0,0,0,0,0,0,0,0,0,0,0,128,0,0,0
17,3/5/2020,5,165,0,0,0,0,0,0,0,0,0,0,1,41,170,42,0,0
17,3/6/2020,5,180,0,0,0,0,0,0,0,0,0,0,0,15,185,15,0,0
17,3/7/2020,6,191,0,0,0,0,0,0,0,0,0,0,1,11,197,12,0,0
17,3/8/2020,6,191,0,0,0,0,0,0,0,0,0,0,0,0,197,0,0,0
17,3/9/2020,7,191,0,0,0,0,0,0,0,0,0,0,1,0,198,1,0,0
17,3/10/2020,19,244,0,0,0,0,0,0,0,0,0,0,12,53,263,65,0,0
17,3/11/2020,19,244,0,0,0,0,0,0,0,0,0,0,0,0,263,0,0,0
17,3/12/2020,25,266,0,0,0,0,0,0,0,0,0,0,6,22,291,28,0,0
17,3/13/2020,32,294,0,0,0,0,0,0,0,0,0,0,7,28,326,35,0,0
17,3/14/2020,46,316,0,0,0,0,0,0,0,0,0,0,14,22,362,36,0,0
17,3/15/2020,64,449,0,0,0,0,0,0,0,0,0,0,18,133,513,151,0,0
17,3/16/2020,93,932,0,0,0,0,0,0,0,0,0,0,29,483,1025,512,0,0
17,3/17/2020,159,1340,0,0,0,0,0,0,0,1,0,0,66,408,1499,474,1,0
17,3/18/2020,288,1763,0,0,0,0,0,0,0,1,0,0,129,423,2051,552,0,0
17,3/19/2020,422,2725,0,0,0,0,0,0,0,4,0,0,134,962,3147,1096,3,0
17,3/20/2020,585,3696,0,0,0,0,0,0,0,5,0,0,163,971,4281,1134,1,0
17,3/21/2020,753,5488,0,0,0,0,0,0,0,6,0,0,168,1792,6241,1960,1,0
17,3/22/2020,1049,7271,0,0,0,0,0,0,0,9,0,0,296,1783,8320,2079,3,0
17,3/23/2020,1273,8583,0,0,0,0,0,0,0,12,0,0,224,1312,9856,1536,3,0
17,3/24/2020,1535,9934,0,0,0,0,0,0,0,16,0,0,262,1351,11469,1613,4,0
17,3/25/2020,1865,12344,0,0,0,0,0,0,0,19,0,0,330,2410,14209,2740,3,0
17,3/26/2020,2538,14093,0,0,0,0,0,0,0,26,0,0,673,1749,16631,2422,7,0
17,3/27/2020,3026,18516,0,0,0,0,0,0,0,34,0,0,488,4423,21542,4911,8,0
17,3/28/2020,3491,22000,0,0,0,0,0,0,0,47,0,0,465,3484,25491,3949,13,0
17,3/29/2020,4596,23166,0,0,0,0,0,0,0,65,0,0,1105,1166,27762,2271,18,0
17,3/30/2020,5057,25389,0,0,0,0,0,0,0,73,0,0,461,2223,30446,2684,8,0
17,3/31/2020,5994,29231,0,0,0,0,0,0,0,99,0,0,937,3842,35225,4779,26,0
17,4/1/2020,6980,33404,0,0,0,0,0,0,0,141,0,0,986,4173,40384,5159,42,0
17,4/2/2020,7695,35961,0,0,0,0,0,0,0,157,0,0,715,2557,43656,3272,16,0
17,4/3/2020,8904,39144,0,0,0,0,0,0,0,210,0,0,1209,3183,48048,4392,53,0
17,4/4/2020,10357,43224,0,0,0,0,0,0,0,243,0,0,1453,4080,53581,5533,33,0
17,4/5/2020,11256,47727,0,0,0,0,0,0,0,274,0,0,899,4503,58983,5402,31,0
17,4/6/2020,12262,50680,0,0,0,0,0,0,0,307,0,0,1006,2953,62942,3959,33,0
17,4/7/2020,13549,55183,3680,0,1166,0,821,0,0,380,0,0,1287,4503,68732,5790,73,0
17,4/8/2020,15078,59988,3680,0,1166,0,821,0,0,462,0,0,1529,4805,75066,6334,82,0
17,4/9/2020,16422,64435,3680,0,1166,0,821,0,0,528,0,0,1344,4447,80857,5791,66,0
17,4/10/2020,17887,69640,3680,0,1166,0,821,0,0,596,0,0,1465,5205,87527,6670,68,0
17,4/11/2020,19180,72969,3680,0,1166,0,821,0,0,677,0,0,1293,3329,92149,4622,81,0
17,4/12/2020,20852,79883,3680,0,1166,0,821,0,0,720,0,0,1672,6914,100735,8586,43,0
17,4/13/2020,22025,83743,3680,0,1166,0,821,0,0,794,0,0,1173,3860,105768,5033,74,0
17,4/14/2020,23247,87369,4283,0,1189,0,796,0,0,868,0,0,1222,3626,110616,4848,74,0
17,4/15/2020,24593,92336,4283,0,1189,0,796,0,0,948,0,0,1346,4967,116929,6313,80,0
17,4/16/2020,25733,96856,4423,0,1248,0,797,0,0,1072,0,0,1140,4520,122589,5660,124,0
17,4/17/2020,27575,102588,4454,0,1196,0,777,0,0,1134,0,0,1842,5732,130163,7574,62,0
17,4/18/2020,29160,108244,4340,0,1192,0,740,0,0,1259,0,0,1585,5656,137404,7241,125,0
17,4/19/2020,30357,112961,4314,0,1196,0,749,0,0,1290,0,0,1197,4717,143318,5914,31,0
17,4/20/2020,31508,116850,4599,0,1239,0,757,0,0,1349,0,0,1151,3889,148358,5040,59,0
17,4/21/2020,33059,121938,4776,0,1226,0,781,0,0,1468,0,0,1551,5088,154997,6639,119,0
17,4/22/2020,35108,129238,4665,0,1220,0,747,0,0,1565,0,0,2049,7300,164346,9349,97,0
17,4/23/2020,36934,136382,4877,0,1268,0,766,0,0,1688,0,0,1826,7144,173316,8970,123,0
17,4/24/2020,39658,149974,4828,0,1225,0,709,0,0,1795,0,0,2724,13592,189632,16316,107,0
17,4/25/2020,41777,159840,4699,0,1244,0,763,0,0,1874,0,0,2119,9866,201617,11985,79,0
17,4/26/2020,43903,171049,4595,0,1267,0,772,0,0,1933,0,0,2126,11209,214952,13335,59,0
17,4/27/2020,45883,181745,4672,0,1249,0,763,0,0,1983,0,0,1980,10696,227628,12676,50,0
17,4/28/2020,48102,194087,4738,0,1245,0,778,0,0,2125,0,0,2219,12342,242189,14561,142,0
17,4/29/2020,50355,206312,5036,0,1290,0,777,0,0,2215,0,0,2253,12225,256667,14478,90,0
17,4/30/2020,52918,216949,4953,0,1289,0,785,0,0,2355,0,0,2563,10637,269867,13200,140,0
17,5/1/2020,56055,228633,4900,0,1263,0,777,0,0,2457,0,0,3137,11684,284688,14821,102,0
17,5/2/2020,58505,241391,4717,0,1250,0,789,0,0,2559,0,0,2450,12758,299896,15208,102,0
17,5/3/2020,61499,257814,4701,0,1232,0,759,0,0,2618,0,0,2994,16423,319313,19417,59,0
17,5/4/2020,63840,269307,4493,0,1232,0,763,0,0,2662,0,0,2341,11493,333147,13834,44,0
17,5/5/2020,65962,280324,4780,0,1266,0,780,0,0,2838,0,0,2122,11017,346286,13139,176,0
17,5/6/2020,68232,293028,4832,0,1231,0,780,0,0,2974,0,0,2270,12704,361260,14974,136,0
17,5/7/2020,70873,308170,4862,0,1253,0,766,0,0,3111,0,0,2641,15142,379043,17783,137,0
17,5/8/2020,73760,325954,4750,0,1222,0,727,0,0,3241,0,0,2887,17784,399714,20671,130,0
17,5/9/2020,76085,340246,4739,0,1215,0,739,0,0,3349,0,0,2325,14292,416331,16617,108,0
17,5/10/2020,77741,352243,4293,0,1232,0,709,0,0,3406,0,0,1656,11997,429984,13653,57,0
17,5/11/2020,79007,363418,4319,0,1248,0,730,0,0,3459,0,0,1266,11175,442425,12441,53,0
17,5/12/2020,83021,388670,4626,0,1215,0,730,0,0,3601,3601,0,4014,25252,471691,29266,142,0
17,5/13/2020,84698,404661,4563,0,1208,0,714,0,0,3792,3792,0,1677,15991,489359,17668,191,0
17,5/14/2020,87937,424100,4473,0,1132,0,689,0,0,3928,3928,0,3239,19439,512037,22678,136,0
17,5/15/2020,90369,448233,4367,0,1129,0,675,0,0,4058,4058,0,2432,24133,538602,26565,130,0
17,5/16/2020,92457,469192,4306,0,1135,0,653,0,0,4129,4129,0,2088,20959,561649,23047,71,0
17,5/17/2020,94191,487753,4190,0,1144,0,735,0,0,4177,4177,0,1734,18561,581944,20295,48,0
17,5/18/2020,96485,506756,4120,0,1096,0,636,0,0,4234,4234,0,2294,19003,603241,21297,57,0
17,5/19/2020,98030,523654,4002,0,993,0,576,0,0,4379,4379,0,1545,16898,621684,18443,145,0
17,5/20/2020,100418,542295,3914,0,1005,0,554,0,0,4525,4525,0,2388,18641,642713,21029,146,0
17,5/21/2020,102686,569334,4107,0,1088,0,609,0,0,4607,4607,0,2268,27039,672020,29307,82,0
17,5/22/2020,105444,591689,3928,0,1060,0,589,0,0,4715,4715,0,2758,22355,697133,25113,108,0
17,5/23/2020,107796,614451,3753,0,1027,0,607,0,0,4790,4790,0,2352,22762,722247,25114,75,0
17,5/24/2020,110304,637617,3667,0,1007,0,632,0,0,4856,4856,0,2508,23166,747921,25674,66,0
17,5/25/2020,112017,657547,3762,0,1025,0,605,0,0,4884,4884,0,1713,19930,769564,21643,28,0
17,5/26/2020,113195,673599,3788,0,1035,0,590,0,0,4923,4923,0,1178,16052,786794,17230,39,0
17,5/27/2020,114306,689667,3826,0,1031,0,592,0,0,5083,5083,0,1111,16068,803973,17179,160,0
17,5/28/2020,115833,714133,3649,0,1009,0,576,0,0,5186,5186,0,1527,24466,829966,25993,103,0
17,5/29/2020,117455,734307,3599,0,980,0,593,0,0,5270,5270,0,1622,20174,851762,21796,84,0
17,5/30/2020,118917,758188,3336,0,925,0,661,0,0,5330,5330,0,1462,23881,877105,25343,60,0
17,5/31/2020,120260,777999,3296,0,941,0,550,0,0,5390,5390,0,1343,19811,898259,21154,60,0
17,6/1/2020,121234,797039,3215,0,902,0,547,0,0,5412,5412,0,974,19040,918273,20014,22,0
17,6/2/2020,122848,811856,3238,0,874,0,548,0,0,5525,5525,0,1614,14817,934704,16431,113,0
17,6/3/2020,123830,835345,3173,0,844,0,508,0,0,5621,5621,0,982,23489,959175,24471,96,0
17,6/4/2020,124759,857257,3044,0,853,0,516,0,0,5736,5736,0,929,21912,982016,22841,115,0
17,6/5/2020,125915,875004,2911,0,817,0,500,0,0,5795,5795,0,1156,17747,1000919,18903,59,0
17,6/6/2020,126890,895184,2702,0,770,0,476,0,0,5864,5864,0,975,20180,1022074,21155,69,0
17,6/7/2020,127757,915017,2550,0,720,0,438,0,0,5904,5904,0,867,19833,1042774,20700,40,0
17,6/8/2020,129139,930458,2496,0,713,0,443,0,0,6102,5924,178,1382,15441,1059597,16823,198,0
17,6/9/2020,129936,949970,2573,0,726,0,437,0,0,6196,6018,178,797,19512,1079906,20309,94,0
17,6/10/2020,130561,970165,2458,0,706,0,394,0,0,6273,6095,178,625,20195,1100726,20820,77,0
17,6/11/2020,131327,991724,2365,0,638,0,379,0,0,6363,6185,178,766,21559,1123051,22325,90,0
17,6/12/2020,132059,1015903,2209,0,648,0,375,0,0,6441,6260,181,732,24179,1147962,24911,78,0
17,6/13/2020,132732,1037074,2117,0,610,0,352,0,0,6470,6289,181,673,21171,1169806,21844,29,0
17,6/14/2020,133404,1058442,1914,0,562,0,328,0,0,6489,6308,181,672,21368,1191846,22040,19,0
17,6/15/2020,133877,1076596,1961,0,569,0,340,0,0,6507,6326,181,473,18154,1210473,18627,18,0
17,6/16/2020,134500,1094702,1939,0,561,0,331,0,0,6579,6398,181,623,18106,1229202,18729,72,0
17,6/17/2020,135046,1124143,1878,0,563,0,331,0,0,6666,6485,181,546,29441,1259189,29987,87,0
17,6/18/2020,135639,1149054,1878,0,538,0,321,0,0,6718,6537,181,593,24911,1284693,25504,52,0
17,6/19/2020,136470,1175533,1837,0,512,0,293,0,0,6718,6580,204,831,26479,1312003,27310,0,0
17,6/20/2020,137104,1200864,1696,0,454,0,274,0,0,6829,6625,204,634,25331,1337968,25965,111,0
17,6/21/2020,137762,1224022,1631,0,422,0,256,0,0,6851,6647,204,658,23158,1361784,23816,22,0
17,6/22/2020,138224,1241779,1628,0,419,0,250,0,0,6875,6671,204,462,17757,1380003,18219,24,0
17,6/23/2020,138825,1261685,1648,0,424,0,236,0,0,6911,6707,204,601,19906,1400510,20507,36,0
17,6/24/2020,139540,1290301,1614,0,389,0,219,0,0,6974,6770,204,715,28616,1429841,29331,63,0
17,6/25/2020,140434,1321093,1626,0,399,0,216,0,0,7014,6810,204,894,30792,1461527,31686,40,0
17,6/26/2020,141344,1350661,1516,0,400,0,225,0,0,7048,6847,201,910,29568,1492005,30478,34,0
17,6/27/2020,142130,1380112,1516,0,400,0,225,0,0,7074,6873,201,786,29451,1522242,30237,26,0
17,6/28/2020,142776,1403255,1464,0,373,0,193,0,0,7089,6888,201,646,23143,1546031,23789,15,0
17,6/29/2020,143514,1429435,1501,0,372,0,187,0,0,7103,6902,201,738,26180,1572949,26918,14,0
17,6/30/2020,144238,1459780,1560,0,401,0,185,0,0,7124,6923,201,724,30345,1604018,31069,21,0
17,7/1/2020,145066,1492042,1511,0,384,0,189,0,0,7152,6951,201,828,32262,1637108,33090,28,0
17,7/2/2020,145935,1521435,1651,0,349,0,195,0,0,7188,6987,201,869,29393,1667370,30262,36,0
17,7/3/2020,146872,1554885,1349,0,334,0,164,0,0,7215,7005,210,937,33450,1701757,34387,27,0
17,7/4/2020,147734,1587859,1346,0,336,0,182,0,0,7224,7014,210,862,32974,1735593,33836,9,0
17,7/5/2020,148373,1614455,1326,0,304,0,165,0,0,7230,7020,210,639,26596,1762828,27235,6,0
17,7/6/2020,148987,1634975,1395,0,321,0,151,0,0,7236,7026,210,614,20520,1783962,21134,6,0
17,7/7/2020,149574,1661382,1385,0,320,0,153,0,0,7273,7063,210,587,26407,1810956,26994,37,0
17,7/8/2020,150554,1693144,1385,0,320,0,153,0,0,7309,7099,210,980,31762,1843698,32742,36,0
17,7/9/2020,151572,1728306,1507,0,317,0,153,0,0,7329,7119,210,1018,35162,1879878,36180,20,0
17,7/10/2020,152899,1759976,1436,0,306,0,155,0,0,7345,7144,201,1327,31670,1912875,32997,16,0
17,7/11/2020,154094,1791126,1398,0,321,0,139,0,0,7369,7168,201,1195,31150,1945220,32345,24,0
17,7/12/2020,155048,1829066,1342,0,311,0,127,0,0,7388,7187,201,954,37940,1984114,38894,19,0
17,7/13/2020,155931,1858195,1362,0,334,0,136,0,0,7394,7193,201,883,29129,2014126,30012,6,0
17,7/14/2020,156638,1885934,1416,0,333,0,126,0,0,7419,7218,201,707,27739,2042572,28446,25,0
17,7/15/2020,157825,1922908,1454,0,324,0,130,0,0,7427,7226,201,1187,36974,2080733,38161,8,0
17,7/16/2020,159082,1964657,1434,0,311,0,127,0,0,7452,7251,201,1257,41749,2123739,43006,25,0
17,7/17/2020,160509,2006965,1431,0,309,0,128,0,0,7465,7272,193,1427,42308,2167474,43735,13,0
18,3/6/2020,1,0,0,0,0,0,0,0,0,0,0,0,0,0,1,0,0,0
18,3/7/2020,1,0,0,0,0,0,0,0,0,0,0,0,0,0,1,0,0,0
18,3/8/2020,2,0,0,0,0,0,0,0,0,0,0,0,1,0,2,1,0,0
18,3/9/2020,2,0,0,0,0,0,0,0,0,0,0,0,0,0,2,0,0,0
18,3/10/2020,6,30,0,0,0,0,0,0,0,0,0,0,4,30,36,34,0,0
18,3/11/2020,10,33,0,0,0,0,0,0,0,0,0,0,4,3,43,7,0,0
18,3/12/2020,12,52,0,0,0,0,0,0,0,0,0,0,2,19,64,21,0,0
18,3/13/2020,12,61,0,0,0,0,0,0,0,0,0,0,0,9,73,9,0,0
18,3/14/2020,15,74,0,0,0,0,0,0,0,0,0,0,3,13,89,16,0,0
18,3/15/2020,19,102,0,0,0,0,0,0,0,0,0,0,4,28,121,32,0,0
18,3/16/2020,24,115,0,0,0,0,0,0,0,1,0,0,5,13,139,18,1,0
18,3/17/2020,30,129,0,0,0,0,0,0,0,2,0,0,6,14,159,20,1,0
18,3/18/2020,39,154,0,0,0,0,0,0,0,2,0,0,9,25,193,34,0,0
18,3/19/2020,56,324,0,0,0,0,0,0,0,2,0,0,17,170,380,187,0,0
18,3/20/2020,79,475,0,0,0,0,0,0,0,2,0,0,23,151,554,174,0,0
18,3/21/2020,126,707,0,1,0,0,0,0,0,4,0,0,47,232,833,279,2,1
18,3/22/2020,201,1293,0,1,0,0,0,0,0,6,0,0,75,586,1494,661,2,0
18,3/23/2020,259,1701,0,1,0,0,0,0,0,7,0,0,58,408,1960,466,1,0
18,3/24/2020,365,2566,0,1,0,0,0,0,0,12,0,0,106,865,2931,971,5,0
18,3/25/2020,477,2879,0,1,0,0,0,0,0,14,0,0,112,313,3356,425,2,0
18,3/26/2020,645,4006,0,0,0,0,0,0,0,17,0,0,168,1127,4651,1295,3,-1
18,3/27/2020,981,5955,0,0,0,0,0,0,0,24,0,0,336,1949,6936,2285,7,0
18,3/28/2020,1232,7175,0,0,0,0,0,0,0,31,0,0,251,1220,8407,1471,7,0
18,3/29/2020,1514,8316,0,0,0,0,0,0,0,32,0,0,282,1141,9830,1423,1,0
18,3/30/2020,1786,9872,0,0,0,0,0,0,0,35,0,0,272,1556,11658,1828,3,0
18,3/31/2020,2159,11214,0,0,0,0,0,0,0,49,0,0,373,1342,13373,1715,14,0
18,4/1/2020,2565,11810,0,0,0,0,0,0,0,65,0,0,406,596,14375,1002,16,0
18,4/2/2020,3039,13246,0,0,0,0,0,0,0,78,0,0,474,1436,16285,1910,13,0
18,4/3/2020,3437,14398,0,0,0,0,0,0,0,102,0,0,398,1152,17835,1550,24,0
18,4/4/2020,3953,15847,0,0,0,0,0,0,0,116,0,0,516,1449,19800,1965,14,0
18,4/5/2020,4411,18241,0,0,0,0,0,0,0,127,0,0,458,2394,22652,2852,11,0
18,4/6/2020,4944,21247,0,0,924,0,507,0,0,139,0,0,533,3006,26191,3539,12,0
18,4/7/2020,5507,23257,0,0,924,0,507,0,0,173,0,0,563,2010,28764,2573,34,0
18,4/8/2020,5943,24926,0,0,924,0,507,0,0,203,0,0,436,1669,30869,2105,30,0
18,4/9/2020,6351,25782,0,0,924,0,507,0,0,245,0,0,408,856,32133,1264,42,0
18,4/10/2020,6907,28133,0,0,820,0,497,0,0,300,0,0,556,2351,35040,2907,55,0
18,4/11/2020,7435,31780,0,0,820,0,497,0,0,330,0,0,528,3647,39215,4175,30,0
18,4/12/2020,7928,34561,0,0,820,0,497,0,0,343,0,0,493,2781,42489,3274,13,0
18,4/13/2020,8236,36303,0,0,740,0,459,0,0,350,0,0,308,1742,44539,2050,7,0
18,4/14/2020,8527,37490,0,0,721,0,435,0,0,388,0,0,291,1187,46017,1478,38,0
18,4/15/2020,8955,39441,0,0,737,0,422,0,0,436,0,0,428,1951,48396,2379,48,0
18,4/16/2020,9542,41573,0,0,696,0,426,0,0,477,0,0,587,2132,51115,2719,41,0
18,4/17/2020,10154,44631,0,0,638,0,417,0,0,519,0,0,612,3058,54785,3670,42,0
18,4/18/2020,10641,46232,0,0,663,0,360,0,0,545,0,0,487,1601,56873,2088,26,0
18,4/19/2020,11210,49932,0,0,649,0,342,0,0,562,0,0,569,3700,61142,4269,17,0
18,4/20/2020,11686,52953,0,0,669,0,353,0,0,569,0,0,476,3021,64639,3497,7,0
18,4/21/2020,12097,55167,0,0,676,0,368,0,0,630,0,0,411,2214,67264,2625,61,0
18,4/22/2020,12438,57032,0,0,633,0,334,0,0,661,0,0,341,1865,69470,2206,31,0
18,4/23/2020,13039,59001,0,0,652,0,333,0,0,706,0,0,601,1969,72040,2570,45,0
18,4/24/2020,13680,61873,0,0,621,0,325,0,0,741,0,0,641,2872,75553,3513,35,0
18,4/25/2020,14395,65379,1515,0,598,0,324,0,0,785,0,0,715,3506,79774,4221,44,0
18,4/26/2020,15012,66696,1446,0,589,0,310,0,0,813,0,0,617,1317,81708,1934,28,0
18,4/27/2020,15961,68515,1493,0,581,0,284,0,0,844,0,0,949,1819,84476,2768,31,0
18,4/28/2020,16588,70593,1518,0,546,0,275,0,0,901,0,0,627,2078,87181,2705,57,0
18,4/29/2020,17182,74368,1484,0,570,0,262,0,0,1065,0,0,594,3775,91550,4369,164,0
18,4/30/2020,17835,77163,1466,0,549,0,275,0,0,1114,0,0,653,2795,94998,3448,49,0
18,5/1/2020,18630,81009,1431,0,514,0,257,0,0,1175,0,0,795,3846,99639,4641,61,0
18,5/2/2020,19295,84846,1456,0,487,0,244,0,0,1229,0,0,665,3837,104141,4502,54,0
18,5/3/2020,19933,88926,1398,0,476,0,242,0,0,1246,0,0,638,4080,108859,4718,17,0
18,5/4/2020,20507,92790,1449,0,483,0,249,0,0,1264,0,0,574,3864,113297,4438,18,0
18,5/5/2020,21033,94801,1537,0,480,0,272,0,0,1326,0,0,526,2011,115834,2537,62,0
18,5/6/2020,21870,98626,1558,0,526,0,281,0,0,1377,0,0,837,3825,120496,4662,51,0
18,5/7/2020,22503,102279,1457,0,487,0,228,0,0,1414,0,0,633,3653,124782,4286,37,0
18,5/8/2020,23146,106982,1379,4389,481,990,219,0,0,1447,0,0,643,4703,130128,5346,33,4389
18,5/9/2020,23732,111954,1361,4389,458,990,213,0,0,1490,0,0,586,4972,135686,5558,43,0
18,5/10/2020,24126,115903,1328,4389,462,990,205,0,0,1508,0,0,394,3949,140029,4343,18,0
18,5/11/2020,24627,122061,1346,4389,452,990,213,0,0,1540,0,0,501,6158,146688,6659,32,0
18,5/12/2020,25127,125383,1283,4389,472,0,212,0,0,1578,1444,134,500,3322,150510,3822,38,0
18,5/13/2020,25473,128610,1336,4389,481,990,217,0,0,1619,1482,137,346,3227,154083,3573,41,0
18,5/14/2020,26053,134186,1381,4389,488,990,217,0,0,1646,1508,138,580,5576,160239,6156,27,0
18,5/15/2020,26655,138793,1294,4389,492,990,213,0,0,1691,1550,138,602,4607,165448,5209,45,0
18,5/16/2020,27280,144078,1274,4389,426,990,199,0,0,1741,1596,145,625,5285,171358,5910,50,0
18,5/17/2020,27778,149465,1246,4389,441,990,205,0,0,1751,1607,144,498,5387,177243,5885,10,0
18,5/18/2020,28255,155657,1244,4389,426,990,212,0,0,1765,1621,144,477,6192,183912,6669,14,0
18,5/19/2020,28705,160625,1268,4389,421,990,206,0,0,1824,1678,146,450,4968,189330,5418,59,0
18,5/20/2020,29274,166464,1288,4389,431,990,197,0,0,1864,1716,148,569,5839,195738,6408,40,0
18,5/21/2020,29936,173059,1166,4389,409,990,175,0,0,1913,1764,149,662,6595,202995,7257,49,0
18,5/22/2020,30409,178152,1203,5285,416,1166,173,0,0,1941,1791,150,473,5093,208561,5566,28,896
18,5/23/2020,30901,184032,1138,5285,403,1166,173,0,0,1943,1812,152,492,5880,214933,6372,2,0
18,5/24/2020,31376,189425,1112,5285,396,1166,173,0,0,1976,1824,152,475,5393,220801,5868,33,0
18,5/25/2020,31715,194536,1102,5285,365,1166,169,0,0,1976,1832,152,339,5111,226251,5450,0,0
18,5/26/2020,32078,198671,1088,5285,365,1166,163,0,0,2004,1850,154,363,4135,230749,4498,28,0
18,5/27/2020,32437,202896,1122,5285,400,1166,182,0,0,2030,1871,159,359,4225,235333,4584,26,0
18,5/28/2020,33068,209219,1131,5285,411,1166,178,0,0,2068,1907,161,631,6323,242287,6954,38,0
18,5/29/2020,33558,215155,1149,5285,412,1166,161,0,0,2110,1946,164,490,5936,248713,6426,42,0
18,5/30/2020,34211,222184,1149,5285,412,1166,161,0,0,2125,1958,167,653,7029,256395,7682,15,0
18,5/31/2020,34574,226972,1050,5285,372,1248,143,0,21704,2134,1967,167,363,4788,261546,5151,9,0
18,6/1/2020,34830,231066,1041,5860,366,1255,148,0,22224,2142,1976,166,256,4094,265896,4350,8,575
18,6/2/2020,35237,236682,961,5902,358,1261,140,0,22623,2197,2022,175,407,5616,271919,6023,55,42
18,6/3/2020,35712,242103,1017,5952,358,1282,138,0,23182,2207,2032,175,475,5421,277815,5896,10,50
18,6/4/2020,36096,249138,979,5999,372,1286,144,0,23707,2231,2052,179,384,7035,285234,7419,24,47
18,6/5/2020,36578,255060,924,6053,368,1293,147,0,24317,2258,2078,180,482,5922,291638,6404,27,54
18,6/6/2020,36997,260533,926,6091,344,1304,133,0,24729,2292,2110,182,419,5473,297530,5892,34,38
18,6/7/2020,37397,266866,913,6136,335,1317,133,0,25138,2303,2121,182,400,6333,304263,6733,11,45
18,6/8/2020,37623,271880,902,6179,346,1325,130,0,25608,2316,2135,181,226,5014,309503,5240,13,43
18,6/9/2020,38033,277357,853,6225,307,1330,113,0,26205,2339,2158,181,410,5477,315390,5887,23,46
18,6/10/2020,38337,281757,894,6261,307,1334,113,0,26791,2355,2173,182,304,4400,320094,4704,16,36
18,6/11/2020,38748,288594,887,6314,331,1345,118,0,27321,2380,2198,182,411,6837,327342,7248,25,53
18,6/12/2020,39146,296034,906,6349,329,1354,116,0,27811,2396,2214,182,398,7440,335180,7838,16,35
18,6/13/2020,39543,301094,871,6349,316,1354,118,0,28241,2413,2231,182,397,5060,340637,5457,17,0
18,6/14/2020,39909,308482,869,6419,301,1360,113,0,28522,2422,2240,182,366,7388,348391,7754,9,70
18,6/15/2020,40430,315399,882,6451,305,1368,123,0,28744,2433,2251,182,521,6917,355829,7438,11,32
18,6/16/2020,40786,322959,860,6481,313,1383,121,0,29093,2447,2265,182,356,7560,363745,7916,14,30
18,6/17/2020,41013,330169,789,6526,238,1384,105,0,29671,2475,2289,186,227,7210,371182,7437,28,45
18,6/18/2020,41438,343284,754,6589,236,1389,103,0,30175,2491,2304,187,425,13115,384722,13540,16,63
18,6/19/2020,41746,351141,773,6731,259,1465,111,0,30760,2516,2327,189,308,7857,392887,8165,25,142
18,6/20/2020,42061,359741,768,6755,231,1444,113,0,31110,2536,2346,190,315,8600,401802,8915,20,24
18,6/21/2020,42423,369497,744,6788,226,1450,124,0,31302,2540,2350,190,362,9756,411920,10118,4,33
18,6/22/2020,42633,376283,756,6819,283,1452,108,0,31739,2553,2363,190,210,6786,418916,6996,13,31
18,6/23/2020,42871,383505,736,6853,297,1447,110,0,32152,2569,2377,192,238,7222,426376,7460,16,34
18,6/24/2020,43140,388743,701,6883,263,1446,89,0,32152,2578,2386,192,269,5238,431883,5507,9,30
18,6/25/2020,43655,400597,723,6912,276,1452,91,0,33036,2586,2394,192,515,11854,444252,12369,8,29
18,6/26/2020,44140,409750,692,6944,281,1458,94,0,33396,2595,2403,192,485,9153,453890,9638,9,32
18,6/27/2020,44575,418442,595,6982,257,1461,82,0,33725,2616,2424,192,435,8692,463017,9127,21,38
18,6/28/2020,44930,425605,617,7003,266,1468,86,0,33935,2619,2427,192,355,7163,470535,7518,3,21
18,6/29/2020,45228,431291,626,7024,265,1469,85,0,34348,2624,2432,192,298,5686,476519,5984,5,21
18,6/30/2020,45594,438602,695,7065,272,1477,97,0,34646,2640,2448,192,366,7311,484196,7677,16,41
18,7/1/2020,45952,443764,668,7095,232,1483,103,0,35025,2650,2456,194,358,5162,489716,5520,10,30
18,7/2/2020,46387,450448,644,7139,221,1493,89,0,35405,2662,2469,193,435,6684,496835,7119,12,44
18,7/3/2020,46915,457238,633,7175,217,1506,81,0,35756,2681,2488,193,528,6790,504153,7318,19,36
18,7/4/2020,47432,464856,632,7216,218,1516,87,0,36076,2687,2494,193,517,7618,512288,8135,6,41
18,7/5/2020,48008,473714,632,7254,218,1526,87,0,36475,2693,2500,193,576,8858,521722,9434,6,38
18,7/6/2020,48331,478261,613,7285,229,1526,88,0,36788,2698,2505,193,323,4547,526592,4870,5,31
18,7/7/2020,48626,481449,655,7333,213,1540,76,0,36999,2717,2524,193,295,3188,530075,3483,19,48
18,7/8/2020,49063,486794,667,7365,217,1551,87,0,37462,2732,2539,193,437,5345,535857,5782,15,32
18,7/9/2020,49575,492717,686,7386,226,1556,89,0,37795,2739,2546,193,512,5923,542292,6435,7,21
18,7/10/2020,50300,500262,667,7458,217,1577,87,0,38120,2748,2555,193,725,7545,550562,8270,9,72
18,7/11/2020,51079,507067,714,7458,237,1577,72,0,38441,2756,2563,193,779,6805,558146,7584,8,0
18,7/12/2020,51612,513035,702,7527,237,1592,68,0,38623,2760,2567,193,533,5968,564647,6501,4,69
18,7/13/2020,52037,518372,764,7574,255,1601,71,0,38914,2762,2569,193,425,5337,570409,5762,2,47
18,7/14/2020,52685,525724,767,7633,266,1620,73,0,39155,2775,2582,193,648,7352,578409,8000,13,59
18,7/15/2020,53370,533219,881,7686,284,1634,79,0,39571,2785,2592,193,685,7495,586589,8180,10,53
18,7/16/2020,54080,541478,827,7747,292,1643,86,0,40004,2795,2602,193,710,8259,595558,8969,10,61
18,7/17/2020,54813,549822,815,7814,258,1658,80,0,40421,2803,2610,193,733,8344,604635,9077,8,67
19,3/6/2020,0,15,0,0,0,0,0,0,0,0,0,0,0,0,15,0,0,0
19,3/7/2020,0,15,0,0,0,0,0,0,0,0,0,0,0,0,15,0,0,0
19,3/8/2020,0,15,0,0,0,0,0,0,0,0,0,0,0,0,15,0,0,0
19,3/9/2020,3,26,0,0,0,0,0,0,0,0,0,0,3,11,29,14,0,0
19,3/10/2020,8,32,0,0,0,0,0,0,0,0,0,0,5,6,40,11,0,0
19,3/11/2020,13,46,0,0,0,0,0,0,0,0,0,0,5,14,59,19,0,0
19,3/12/2020,14,67,0,0,0,0,0,0,0,0,0,0,1,21,81,22,0,0
19,3/13/2020,16,83,0,0,0,0,0,0,0,0,0,0,2,16,99,18,0,0
19,3/14/2020,17,83,0,0,0,0,0,0,0,0,0,0,1,0,100,1,0,0
19,3/15/2020,18,83,0,0,0,0,0,0,0,0,0,0,1,0,101,1,0,0
19,3/16/2020,22,83,0,0,0,0,0,0,0,0,0,0,4,0,105,4,0,0
19,3/17/2020,23,83,0,0,0,0,0,0,0,0,0,0,1,0,106,1,0,0
19,3/18/2020,29,83,0,0,0,0,0,0,0,0,0,0,6,0,112,6,0,0
19,3/19/2020,38,83,0,0,0,0,0,0,0,0,0,0,9,0,121,9,0,0
19,3/20/2020,45,642,0,0,0,0,0,0,0,0,0,0,7,559,687,566,0,0
19,3/21/2020,68,1049,0,0,0,0,0,0,0,0,0,0,23,407,1117,430,0,0
19,3/22/2020,90,1215,0,0,0,0,0,0,0,0,0,0,22,166,1305,188,0,0
19,3/23/2020,105,2043,0,0,0,0,0,0,0,0,0,0,15,828,2148,843,0,0
19,3/24/2020,124,2315,0,27,0,0,0,0,0,0,0,0,19,272,2439,291,0,27
19,3/25/2020,145,2578,23,36,0,0,0,0,0,1,0,0,21,263,2723,284,1,9
19,3/26/2020,179,2578,31,46,0,0,0,0,15,1,0,0,34,0,2757,34,0,10
19,3/27/2020,235,3740,32,50,0,0,0,0,18,3,0,0,56,1162,3975,1218,2,4
19,3/28/2020,298,4375,46,61,0,0,0,0,15,3,0,0,63,635,4673,698,0,11
19,3/29/2020,336,5013,51,68,0,0,0,0,17,4,0,0,38,638,5349,676,1,7
19,3/30/2020,424,6162,51,74,0,0,0,0,23,6,0,0,88,1149,6586,1237,2,6
19,3/31/2020,497,6888,61,94,0,0,0,0,33,7,0,0,73,726,7385,799,1,20
19,4/1/2020,549,7304,63,99,0,0,0,0,118,9,0,0,52,416,7853,468,2,5
19,4/2/2020,614,8054,74,120,0,0,0,0,46,11,0,0,65,750,8668,815,2,21
19,4/3/2020,699,8754,80,138,0,0,0,0,188,11,0,0,85,700,9453,785,0,18
19,4/4/2020,786,9454,85,153,0,0,0,0,188,14,0,0,87,700,10240,787,3,15
19,4/5/2020,868,9973,91,165,0,0,0,0,188,22,0,0,82,519,10841,601,8,12
19,4/6/2020,946,10653,99,179,0,0,0,0,284,25,0,0,78,680,11599,758,3,14
19,4/7/2020,1048,11670,104,193,0,0,0,0,341,26,0,0,102,1017,12718,1119,1,14
19,4/8/2020,1145,12821,122,193,0,0,0,0,431,27,0,0,97,1151,13966,1248,1,0
19,4/9/2020,1270,13703,122,0,0,0,0,0,476,29,0,0,125,882,14973,1007,2,-193
19,4/10/2020,1388,14565,125,0,55,0,30,0,506,31,0,0,118,862,15953,980,2,0
19,4/11/2020,1510,15622,118,0,55,0,30,0,585,34,0,0,122,1057,17132,1179,3,0
19,4/12/2020,1587,16005,129,0,55,0,30,0,674,41,0,0,77,383,17592,460,7,0
19,4/13/2020,1710,16986,142,0,70,0,41,0,741,43,0,0,123,981,18696,1104,2,0
19,4/14/2020,1899,16986,163,0,73,0,41,0,741,49,0,0,189,0,18885,189,6,0
19,4/15/2020,1995,17874,171,0,78,0,43,0,908,53,0,0,96,888,19869,984,4,0
19,4/16/2020,2141,18534,175,0,84,0,48,0,987,60,0,0,146,660,20675,806,7,0
19,4/17/2020,2332,19460,183,0,88,0,52,0,1007,64,0,0,191,926,21792,1117,4,0
19,4/18/2020,2513,20434,193,0,84,0,51,0,1095,74,0,0,181,974,22947,1155,10,0
19,4/19/2020,2902,21648,198,0,86,0,54,0,1171,75,0,0,389,1214,24550,1603,1,0
19,4/20/2020,3159,22661,214,0,91,0,58,0,1235,79,0,0,257,1013,25820,1270,4,0
19,4/21/2020,3641,23974,214,0,89,0,60,0,1293,83,0,0,482,1313,27615,1795,4,0
19,4/22/2020,3748,24496,272,0,92,0,57,0,1428,90,0,0,107,522,28244,629,7,0
19,4/23/2020,3924,25338,282,0,102,0,55,0,1492,96,0,0,176,842,29262,1018,6,0
19,4/24/2020,4445,27528,278,0,104,0,60,0,1604,107,0,0,521,2190,31973,2711,11,0
19,4/25/2020,5092,29258,293,0,108,0,60,0,1723,112,0,0,647,1730,34350,2377,5,0
19,4/26/2020,5476,30614,286,0,99,0,55,0,1900,118,0,0,384,1356,36090,1740,6,0
19,4/27/2020,5868,32282,300,0,100,0,58,0,2021,127,0,0,392,1668,38150,2060,9,0
19,4/28/2020,6376,33447,304,0,98,0,64,0,2164,136,0,0,508,1165,39823,1673,9,0
19,4/29/2020,6843,34494,323,0,100,0,74,0,2428,148,0,0,467,1047,41337,1514,12,0
19,4/30/2020,7145,35522,335,0,121,0,86,0,2697,162,0,0,302,1028,42667,1330,14,0
19,5/1/2020,7884,37708,345,0,121,0,91,0,2899,170,0,0,739,2186,45592,2925,8,0
19,5/2/2020,8641,37708,353,0,131,0,90,0,3156,175,0,0,757,0,46349,757,5,0
19,5/3/2020,9169,44017,378,0,133,0,93,0,3325,184,0,0,528,6309,53186,6837,9,0
19,5/4/2020,9703,47458,389,0,143,0,93,0,3486,188,0,0,534,3441,57161,3975,4,0
19,5/5/2020,10111,50458,407,0,152,0,94,0,3572,207,0,0,408,3000,60569,3408,19,0
19,5/6/2020,10404,52767,414,0,151,0,103,0,3803,219,0,0,293,2309,63171,2602,12,0
19,5/7/2020,11059,55368,417,0,151,0,107,0,4266,231,0,0,655,2601,66427,3256,12,0
19,5/8/2020,11457,58804,407,0,164,0,109,0,4685,243,0,0,398,3436,70261,3834,12,0
19,5/9/2020,11671,59805,402,0,161,0,106,0,5011,252,0,0,214,1001,71476,1215,9,0
19,5/10/2020,11959,62215,413,0,157,0,105,0,5154,265,0,0,288,2410,74174,2698,13,0
19,5/11/2020,12373,65419,394,0,152,0,107,0,5249,271,0,0,414,3204,77792,3618,6,0
19,5/12/2020,12912,68376,385,0,143,0,101,0,5618,289,0,0,539,2957,81288,3496,18,0
19,5/13/2020,13289,72430,388,0,133,0,101,0,5954,306,0,0,377,4054,85719,4431,17,0
19,5/14/2020,13675,75619,405,0,134,0,93,0,6231,318,0,0,386,3189,89294,3575,12,0
19,5/15/2020,14049,79517,387,0,130,0,87,0,6561,336,0,0,374,3898,93566,4272,18,0
19,5/16/2020,14328,81972,387,0,128,0,83,0,6927,346,0,0,279,2455,96300,2734,10,0
19,5/17/2020,14651,85590,376,0,124,0,85,0,7154,351,0,0,323,3618,100241,3941,5,0
19,5/18/2020,14955,88193,382,0,121,0,85,0,7324,355,0,0,304,2603,103148,2907,4,0
19,5/19/2020,15349,92299,383,0,126,0,83,0,8130,372,0,0,394,4106,107648,4500,17,0
19,5/20/2020,15614,95134,381,0,126,0,84,0,8362,388,0,0,265,2835,110748,3100,16,0
19,5/21/2020,16170,100395,376,0,125,0,80,0,8672,406,0,0,556,5261,116565,5817,18,0
19,5/22/2020,16504,103746,362,0,123,0,79,0,9079,425,0,0,334,3351,120250,3685,19,0
19,5/23/2020,16893,107048,362,0,111,0,70,0,9254,444,0,0,389,3302,123941,3691,19,0
19,5/24/2020,17252,110504,363,0,114,0,61,0,9318,454,0,0,359,3456,127756,3815,10,0
19,5/25/2020,17577,115138,377,0,118,0,66,0,9377,459,0,0,325,4634,132715,4959,5,0
19,5/26/2020,17703,117301,379,0,115,0,65,0,9791,478,0,0,126,2163,135004,2289,19,0
19,5/27/2020,18360,121166,393,0,109,0,66,0,10016,491,0,0,657,3865,139526,4522,13,0
19,5/28/2020,18573,124360,383,0,112,0,67,0,10359,504,0,0,213,3194,142933,3407,13,0
19,5/29/2020,18926,128394,376,0,117,0,78,0,10753,522,0,0,353,4034,147320,4387,18,0
19,5/30/2020,19244,131179,368,0,118,0,69,0,11019,531,0,0,318,2785,150423,3103,9,0
19,5/31/2020,19552,136744,341,0,116,0,70,0,11147,534,0,0,308,5565,156296,5873,3,0
19,6/1/2020,19697,139384,339,0,125,0,73,0,11440,551,0,0,145,2640,159081,2785,17,0
19,6/2/2020,20016,143674,327,0,114,0,76,0,11742,561,0,0,319,4290,163690,4609,10,0
19,6/3/2020,20055,144390,314,0,116,0,76,0,12064,574,0,0,39,716,164445,755,13,0
19,6/4/2020,20805,154130,310,0,105,0,70,0,12333,580,0,0,750,9740,174935,10490,6,0
19,6/5/2020,21152,159511,299,0,102,0,62,0,12585,592,0,0,347,5381,180663,5728,12,0
19,6/6/2020,21478,163236,299,0,102,0,62,0,12715,598,0,0,326,3725,184714,4051,6,0
19,6/7/2020,21667,166525,269,0,86,0,54,0,12805,604,0,0,189,3289,188192,3478,6,0
19,6/8/2020,21987,171635,265,0,85,0,53,0,13028,612,0,0,320,5110,193622,5430,8,0
19,6/9/2020,22236,175487,255,0,82,0,51,0,13411,624,0,0,249,3852,197723,4101,12,0
19,6/10/2020,22551,180278,245,0,73,0,49,0,13628,630,0,0,315,4791,202829,5106,6,0
19,6/11/2020,22938,185601,242,0,75,0,48,0,13956,639,0,0,387,5323,208539,5710,9,0
19,6/12/2020,23337,191207,225,0,81,0,47,0,14227,643,0,0,399,5606,214544,6005,4,0
19,6/13/2020,23717,195891,200,0,76,0,43,0,14326,650,0,0,380,4684,219608,5064,7,0
19,6/14/2020,23926,200708,203,0,77,0,47,0,14383,652,0,0,209,4817,224634,5026,2,0
19,6/15/2020,24053,203335,197,0,71,0,51,0,14625,655,0,0,127,2627,227388,2754,3,0
19,6/16/2020,24179,206459,193,0,71,0,49,0,15025,669,0,0,126,3124,230638,3250,14,0
19,6/17/2020,24461,210670,188,0,64,0,47,0,15289,673,0,0,282,4211,235131,4493,4,0
19,6/18/2020,24854,216077,188,0,64,0,47,0,15604,679,0,0,393,5407,240931,5800,6,0
19,6/19/2020,25275,221374,197,0,60,0,37,0,15816,681,0,0,421,5297,246649,5718,2,0
19,6/20/2020,25496,224711,182,0,58,0,30,0,15963,681,0,0,221,3337,250207,3558,0,0
19,6/21/2020,25963,231189,170,0,53,0,27,0,16068,685,0,0,467,6478,257152,6945,4,0
19,6/22/2020,26051,232581,169,0,51,0,28,0,16240,686,0,0,88,1392,258632,1480,1,0
19,6/23/2020,26373,238330,163,0,47,0,26,0,16579,688,0,0,322,5749,264703,6071,2,0
19,6/24/2020,26705,243254,140,0,43,0,25,0,16858,692,0,0,332,4924,269959,5256,4,0
19,6/25/2020,27197,249857,137,0,42,0,26,0,17017,695,0,0,492,6603,277054,7095,3,0
19,6/26/2020,27686,255957,141,0,42,0,24,0,17313,704,0,0,489,6100,283643,6589,9,0
19,6/27/2020,28012,261740,131,0,40,0,22,0,17467,704,0,0,326,5783,289752,6109,0,0
19,6/28/2020,28489,267426,118,0,36,0,18,0,17620,705,0,0,477,5686,295915,6163,1,0
19,6/29/2020,28782,272063,119,0,35,0,18,0,17851,708,0,0,293,4637,300845,4930,3,0
19,6/30/2020,29007,275181,133,0,34,0,20,0,23212,715,0,0,225,3118,304188,3343,7,0
19,7/1/2020,29451,280339,149,0,37,0,21,0,23607,717,0,0,444,5158,309790,5602,2,0
19,7/2/2020,30209,287329,145,0,36,0,18,0,23993,718,0,0,758,6990,317538,7748,1,0
19,7/3/2020,30429,291032,146,0,40,0,20,0,24338,720,0,0,220,3703,321461,3923,2,0
19,7/4/2020,31041,297970,134,0,40,0,16,0,24604,721,0,0,612,6938,329011,7550,1,0
19,7/5/2020,31353,301119,141,0,43,0,16,0,24739,721,0,0,312,3149,332472,3461,0,0
19,7/6/2020,31657,303805,151,0,41,0,15,0,25121,723,0,0,304,2686,335462,2990,2,0
19,7/7/2020,32029,307269,165,0,44,0,20,0,25594,725,0,0,372,3464,339298,3836,2,0
19,7/8/2020,32509,313842,165,0,44,0,23,0,25974,735,0,0,480,6573,346351,7053,10,0
19,7/9/2020,33240,321419,168,0,49,0,22,0,26340,739,0,0,731,7577,354659,8308,4,0
19,7/10/2020,33984,328264,169,0,54,0,26,0,25891,743,0,0,744,6845,362248,7589,4,0
19,7/11/2020,34647,333714,178,0,56,0,25,0,26104,748,0,0,663,5450,368361,6113,5,0
19,7/12/2020,35071,339342,177,0,54,0,26,0,26234,750,0,0,424,5628,374413,6052,2,0
19,7/13/2020,35529,341187,186,0,67,0,32,0,26664,754,0,0,458,1845,376716,2303,4,0
19,7/14/2020,35849,344559,186,0,67,0,32,0,26952,757,0,0,320,3372,380408,3692,3,0
19,7/15/2020,36291,351021,190,0,62,0,30,0,27177,762,0,0,442,6462,387312,6904,5,0
19,7/16/2020,37132,359319,195,0,65,0,34,0,27404,778,0,0,841,8298,396451,9139,16,0
19,7/17/2020,37722,364731,210,0,70,0,32,0,27609,784,0,0,590,5412,402453,6002,6,0
20,3/6/2020,0,4,0,0,0,0,0,0,0,0,0,0,0,0,4,0,0,0
20,3/7/2020,0,11,0,0,0,0,0,0,0,0,0,0,0,7,11,7,0,0
20,3/8/2020,1,11,0,0,0,0,0,0,0,0,0,0,1,0,12,1,0,0
20,3/9/2020,1,11,0,0,0,0,0,0,0,0,0,0,0,0,12,0,0,0
20,3/10/2020,1,17,0,0,0,0,0,0,0,0,0,0,0,6,18,6,0,0
20,3/11/2020,1,41,0,0,0,0,0,0,0,0,0,0,0,24,42,24,0,0
20,3/12/2020,4,41,0,0,0,0,0,0,0,0,0,0,3,0,45,3,0,0
20,3/13/2020,6,93,0,0,0,0,0,0,0,0,0,0,2,52,99,54,0,0
20,3/14/2020,6,93,0,0,0,0,0,0,0,1,0,0,0,0,99,0,1,0
20,3/15/2020,8,135,0,0,0,0,0,0,0,1,0,0,2,42,143,44,0,0
20,3/16/2020,11,166,0,0,0,0,0,0,0,1,0,0,3,31,177,34,0,0
20,3/17/2020,15,382,0,0,0,0,0,0,0,1,0,0,4,216,397,220,0,0
20,3/18/2020,16,417,0,0,0,0,0,0,0,1,0,0,1,35,433,36,0,0
20,3/19/2020,34,417,0,0,0,0,0,0,0,1,0,0,18,0,451,18,0,0
20,3/20/2020,44,417,0,0,0,0,0,0,0,1,0,0,10,0,461,10,0,0
20,3/21/2020,55,417,0,0,0,0,0,0,0,2,0,0,11,0,472,11,1,0
20,3/22/2020,64,417,0,0,0,0,0,0,0,2,0,0,9,0,481,9,0,0
20,3/23/2020,82,417,0,0,0,0,0,0,0,2,0,0,18,0,499,18,0,0
20,3/24/2020,98,2086,0,0,0,0,0,0,0,2,0,0,16,1669,2184,1685,0,0
20,3/25/2020,126,2360,0,0,0,0,0,0,0,3,0,0,28,274,2486,302,1,0
20,3/26/2020,168,2869,0,0,0,0,0,0,0,3,0,0,42,509,3037,551,0,0
20,3/27/2020,202,3229,0,27,0,0,0,0,0,4,0,0,34,360,3431,394,1,27
20,3/28/2020,261,3671,0,27,0,0,0,0,0,5,0,0,59,442,3932,501,1,0
20,3/29/2020,319,4194,0,55,0,0,0,0,0,6,0,0,58,523,4513,581,1,28
20,3/30/2020,368,4554,0,66,0,0,0,0,0,8,0,0,49,360,4922,409,2,11
20,3/31/2020,428,4996,0,79,0,0,0,0,0,9,0,0,60,442,5424,502,1,13
20,4/1/2020,482,5411,0,114,0,0,0,0,0,10,0,0,54,415,5893,469,1,35
20,4/2/2020,552,6059,0,138,0,0,0,0,0,13,0,0,70,648,6611,718,3,24
20,4/3/2020,620,6454,0,151,0,0,0,0,0,17,0,0,68,395,7074,463,4,13
20,4/4/2020,698,6880,0,172,0,0,0,0,0,21,0,0,78,426,7578,504,4,21
20,4/5/2020,747,7476,0,183,0,0,0,0,0,22,0,0,49,596,8223,645,1,11
20,4/6/2020,845,8239,0,198,0,0,0,0,0,25,0,0,98,763,9084,861,3,15
20,4/7/2020,900,8614,0,223,0,0,0,0,0,27,0,0,55,375,9514,430,2,25
20,4/8/2020,1046,9137,0,223,0,0,0,0,0,38,0,0,146,523,10183,669,11,0
20,4/9/2020,1106,9669,0,263,0,0,0,0,0,42,0,0,60,532,10775,592,4,40
20,4/10/2020,1166,10248,0,274,0,0,0,0,0,50,0,0,60,579,11414,639,8,11
20,4/11/2020,1268,11075,0,293,0,0,0,0,0,55,0,0,102,827,12343,929,5,19
20,4/12/2020,1337,11916,0,298,0,0,0,0,0,56,0,0,69,841,13253,910,1,5
20,4/13/2020,1376,12488,0,309,0,0,0,0,0,62,0,0,39,572,13864,611,6,11
20,4/14/2020,1426,12721,0,327,0,0,0,0,0,69,0,0,50,233,14147,283,7,18
20,4/15/2020,1494,13174,0,342,0,0,0,0,0,76,0,0,68,453,14668,521,7,15
20,4/16/2020,1588,14534,0,359,0,0,0,0,0,80,0,0,94,1360,16122,1454,4,17
20,4/17/2020,1705,15196,0,375,0,0,0,0,0,84,0,0,117,662,16901,779,4,16
20,4/18/2020,1790,15886,0,383,0,0,0,0,0,86,0,0,85,690,17676,775,2,8
20,4/19/2020,1849,16281,0,390,0,0,0,0,0,92,0,0,59,395,18130,454,6,7
20,4/20/2020,1986,16775,0,405,0,0,0,0,0,100,0,0,137,494,18761,631,8,15
20,4/21/2020,2025,17076,0,419,0,0,0,0,0,107,0,0,39,301,19101,340,7,14
20,4/22/2020,2211,17992,0,432,0,0,0,0,0,110,0,0,186,916,20203,1102,3,13
20,4/23/2020,2482,18836,0,442,0,0,0,0,0,112,0,0,271,844,21318,1115,2,10
20,4/24/2020,2777,20811,0,457,0,0,0,0,0,111,0,0,295,1975,23588,2270,-1,15
20,4/25/2020,3056,22143,0,474,0,0,0,0,0,117,0,0,279,1332,25199,1611,6,17
20,4/26/2020,3174,23053,0,485,0,0,0,0,0,118,0,0,118,910,26227,1028,1,11
20,4/27/2020,3328,23839,0,496,0,0,0,0,0,120,0,0,154,786,27167,940,2,11
20,4/28/2020,3491,24599,0,504,0,0,0,0,0,124,0,0,163,760,28090,923,4,8
20,4/29/2020,3738,25720,0,515,0,198,0,88,266,125,0,0,247,1121,29458,1368,1,11
20,4/30/2020,4238,27388,0,523,0,201,0,93,272,129,0,0,500,1668,31626,2168,4,8
20,5/1/2020,4449,28585,0,534,0,206,0,96,280,130,0,0,211,1197,33034,1408,1,11
20,5/2/2020,4746,30196,0,541,0,206,0,95,286,131,0,0,297,1611,34942,1908,1,7
20,5/3/2020,5030,31748,0,547,0,209,0,95,286,134,0,0,284,1552,36778,1836,3,6
20,5/4/2020,5245,33358,0,553,0,209,0,95,291,136,0,0,215,1610,38603,1825,2,6
20,5/5/2020,5458,34634,0,566,0,212,0,95,296,137,0,0,213,1276,40092,1489,1,13
20,5/6/2020,5734,36380,0,571,0,213,0,96,318,144,0,0,276,1746,42114,2022,7,5
20,5/7/2020,6144,38678,0,587,0,218,0,97,323,147,0,0,410,2298,44822,2708,3,16
20,5/8/2020,6501,41207,0,608,0,223,0,99,332,152,0,0,357,2529,47708,2886,5,21
20,5/9/2020,6751,43182,0,635,0,229,0,100,350,157,0,0,250,1975,49933,2225,5,27
20,5/10/2020,6948,45557,0,657,0,231,0,101,371,157,0,0,197,2375,52505,2572,0,22
20,5/11/2020,7116,46993,0,660,0,233,0,101,376,158,0,0,168,1436,54109,1604,1,3
20,5/12/2020,7116,46993,0,660,0,233,0,101,376,158,0,0,0,0,54109,0,0,0
20,5/13/2020,7468,50160,0,704,0,238,0,108,422,164,0,0,352,3167,57628,3519,6,44
20,5/14/2020,7468,50160,0,704,0,238,0,108,422,164,0,0,0,0,57628,0,0,0
20,5/15/2020,7886,53706,0,724,0,246,0,112,443,172,0,0,418,3546,61592,3964,8,20
20,5/16/2020,7886,53706,0,724,0,246,0,112,443,172,0,0,0,0,61592,0,0,0
20,5/17/2020,7886,53706,0,724,0,246,0,112,443,172,0,0,0,0,61592,0,0,0
20,5/18/2020,8340,58650,0,740,0,250,0,115,465,173,0,0,454,4944,66990,5398,1,16
20,5/19/2020,8340,58650,0,740,0,250,0,115,465,173,0,0,0,0,66990,0,0,0
20,5/20/2020,8539,62664,0,760,0,258,0,116,473,178,0,0,199,4014,71203,4213,5,20
20,5/21/2020,8539,62664,0,760,0,258,0,116,473,178,0,0,0,0,71203,0,0,0
20,5/22/2020,8958,67476,0,787,0,269,0,120,485,185,0,0,419,4812,76434,5231,7,27
20,5/23/2020,8958,67476,0,787,0,269,0,120,485,185,0,0,0,0,76434,0,0,0
20,5/24/2020,8958,67476,0,787,0,269,0,120,485,185,0,0,0,0,76434,0,0,0
20,5/25/2020,9218,72181,0,800,0,271,0,120,493,188,0,0,260,4705,81399,4965,3,13
20,5/26/2020,9218,72181,0,800,0,271,0,120,493,188,0,0,0,0,81399,0,0,0
20,5/27/2020,9337,75151,0,822,0,275,0,122,534,205,0,0,119,2970,84488,3089,17,22
20,5/28/2020,9337,75151,0,822,0,275,0,122,534,205,0,0,0,0,84488,0,0,0
20,5/29/2020,9719,85230,0,842,0,284,0,124,547,208,0,0,382,10079,94949,10461,3,20
20,5/30/2020,9719,85230,0,842,0,284,0,124,547,208,0,0,0,0,94949,0,0,0
20,5/31/2020,9719,85230,0,842,0,284,0,124,547,208,0,0,0,0,94949,0,0,0
20,6/1/2020,10011,85230,0,842,0,284,0,124,547,217,0,0,292,0,95241,292,9,0
20,6/2/2020,10011,93301,0,862,0,290,0,127,555,217,0,0,0,8071,103312,8071,0,20
20,6/3/2020,10170,97883,0,890,0,302,0,131,592,222,0,0,159,4582,108053,4741,5,28
20,6/4/2020,10170,97883,0,890,0,302,0,131,592,222,0,0,0,0,108053,0,0,0
20,6/5/2020,10393,103260,0,917,0,306,0,135,612,232,0,0,223,5377,113653,5600,10,27
20,6/6/2020,10393,103260,0,917,0,306,0,135,612,232,0,0,0,0,113653,0,0,0
20,6/7/2020,10393,103260,0,917,0,306,0,135,612,232,0,0,0,0,113653,0,0,0
20,6/8/2020,10650,108859,0,936,0,311,0,136,625,236,0,0,257,5599,119509,5856,4,19
20,6/9/2020,10650,108859,0,936,0,311,0,136,625,236,0,0,0,0,119509,0,0,0
20,6/10/2020,10812,112930,0,954,0,316,0,139,657,240,0,0,162,4071,123742,4233,4,18
20,6/11/2020,10812,112930,0,954,0,316,0,139,657,240,0,0,0,0,123742,0,0,0
20,6/12/2020,11047,118105,0,973,0,324,0,143,667,243,0,0,235,5175,129152,5410,3,19
20,6/13/2020,11047,118105,0,973,0,324,0,143,667,243,0,0,0,0,129152,0,0,0
20,6/14/2020,11047,118105,0,973,0,324,0,143,667,243,0,0,0,0,129152,0,0,0
20,6/15/2020,11419,125543,0,988,0,327,0,143,676,245,0,0,372,7438,136962,7810,2,15
20,6/16/2020,11419,125543,0,988,0,327,0,143,676,245,0,0,0,0,136962,0,0,0
20,6/17/2020,11681,130443,0,1011,0,333,0,146,696,247,0,0,262,4900,142124,5162,2,23
20,6/18/2020,11681,130443,0,1011,0,333,0,146,696,247,0,0,0,0,142124,0,0,0
20,6/19/2020,12059,135590,0,1035,0,338,0,146,715,254,0,0,378,5147,147649,5525,7,24
20,6/20/2020,12059,135590,0,1035,0,338,0,146,715,254,0,0,0,0,147649,0,0,0
20,6/21/2020,12059,135590,0,1035,0,338,0,146,715,254,0,0,0,0,147649,0,0,0
20,6/22/2020,12465,142548,0,1056,0,342,0,149,722,259,0,0,406,6958,155013,7364,5,21
20,6/23/2020,12465,142548,0,1056,0,342,0,149,722,259,0,0,0,0,155013,0,0,0
20,6/24/2020,12970,148735,0,1082,0,348,0,150,747,261,0,0,505,6187,161705,6692,2,26
20,6/25/2020,12970,148735,0,1082,0,348,0,150,747,261,0,0,0,0,161705,0,0,0
20,6/26/2020,13538,154321,0,1128,0,356,0,152,779,264,0,0,568,5586,167859,6154,3,46
20,6/27/2020,13538,154321,0,1128,0,356,0,152,779,264,0,0,0,0,167859,0,0,0
20,6/28/2020,13538,154321,0,1128,0,356,0,152,779,264,0,0,0,0,167859,0,0,0
20,6/29/2020,14443,162282,0,1152,0,360,0,152,794,270,0,0,905,7961,176725,8866,6,24
20,6/30/2020,14443,162282,0,1152,0,360,0,152,794,270,0,0,0,0,176725,0,0,0
20,7/1/2020,14990,168183,0,1152,0,367,0,152,834,272,0,0,547,5901,183173,6448,2,0
20,7/2/2020,14990,168183,0,1195,0,367,0,152,834,272,0,0,0,0,183173,0,0,43
20,7/3/2020,15919,175642,0,1219,0,377,0,156,842,277,0,0,929,7459,191561,8388,5,24
20,7/4/2020,15919,175642,0,1219,0,377,0,156,842,277,0,0,0,0,191561,0,0,0
20,7/5/2020,15919,175642,0,1219,0,377,0,156,842,277,0,0,0,0,191561,0,0,0
20,7/6/2020,16901,185318,0,1235,0,384,0,158,859,280,0,0,982,9676,202219,10658,3,16
20,7/7/2020,16901,185318,0,1235,0,384,0,158,859,280,0,0,0,0,202219,0,0,0
20,7/8/2020,17618,190864,0,1269,0,397,0,160,879,282,0,0,717,5546,208482,6263,2,34
20,7/9/2020,17618,190864,0,1269,0,397,0,160,879,282,0,0,0,0,208482,0,0,0
20,7/10/2020,18611,199168,0,1304,0,405,0,160,905,284,0,0,993,8304,217779,9297,2,35
20,7/11/2020,18611,199168,0,1304,0,405,0,160,905,284,0,0,0,0,217779,0,0,0
20,7/12/2020,18611,199168,0,1304,0,405,0,160,905,284,0,0,0,0,217779,0,0,0
20,7/13/2020,20058,211117,0,1343,0,410,0,160,920,288,0,0,1447,11949,231175,13396,4,39
20,7/14/2020,20058,211117,0,1343,0,410,0,160,920,288,0,0,0,0,231175,0,0,0
20,7/15/2020,20933,218441,0,1393,65,418,21,159,948,299,0,0,875,7324,239374,8199,11,50
20,7/16/2020,20933,218441,0,1393,65,418,21,159,948,299,0,0,0,0,239374,0,0,0
20,7/17/2020,21965,227388,0,1453,58,427,14,161,983,299,0,0,1032,8947,249353,9979,0,60
21,3/6/2020,0,7,0,0,0,0,0,0,0,0,0,0,0,0,7,0,0,0
21,3/7/2020,1,9,0,0,0,0,0,0,0,0,0,0,1,2,10,3,0,0
21,3/8/2020,1,13,0,0,0,0,0,0,0,0,0,0,0,4,14,4,0,0
21,3/9/2020,4,17,0,0,0,0,0,0,0,0,0,0,3,4,21,7,0,0
21,3/10/2020,6,28,0,0,0,0,0,0,0,0,0,0,2,11,34,13,0,0
21,3/11/2020,8,46,0,0,0,0,0,0,0,0,0,0,2,18,54,20,0,0
21,3/12/2020,8,56,0,0,0,0,0,0,0,0,0,0,0,10,64,10,0,0
21,3/13/2020,11,107,0,0,0,0,0,0,0,0,0,0,3,51,118,54,0,0
21,3/14/2020,14,139,0,0,0,0,0,0,0,1,0,0,3,32,153,35,1,0
21,3/15/2020,16,139,0,0,0,0,0,0,0,1,0,0,2,0,155,2,0,0
21,3/16/2020,21,234,0,0,0,0,0,0,0,1,0,0,5,95,255,100,0,0
21,3/17/2020,22,295,0,0,0,0,0,0,0,1,0,0,1,61,317,62,0,0
21,3/18/2020,26,354,0,0,0,0,0,0,0,1,0,0,4,59,380,63,0,0
21,3/19/2020,35,454,0,0,0,0,0,0,0,1,0,0,9,100,489,109,0,0
21,3/20/2020,47,592,0,0,0,0,0,0,0,1,0,0,12,138,639,150,0,0
21,3/21/2020,54,714,0,0,0,0,0,0,0,2,0,0,7,122,768,129,1,0
21,3/22/2020,99,1472,0,0,0,0,0,0,0,3,0,0,45,758,1571,803,1,0
21,3/23/2020,104,1762,0,0,0,0,0,0,0,3,0,0,5,290,1866,295,0,0
21,3/24/2020,124,1762,0,0,0,0,0,0,0,4,0,0,20,0,1886,20,1,0
21,3/25/2020,157,2865,0,0,0,0,0,0,0,4,0,0,33,1103,3022,1136,0,0
21,3/26/2020,198,3102,0,0,0,0,0,0,0,4,0,0,41,237,3300,278,0,0
21,3/27/2020,248,3768,0,0,0,0,0,0,0,6,0,0,50,666,4016,716,2,0
21,3/28/2020,302,4821,0,0,0,0,0,0,0,8,0,0,54,1053,5123,1107,2,0
21,3/29/2020,394,5147,0,0,0,0,0,0,0,9,0,0,92,326,5541,418,1,0
21,3/30/2020,439,5579,0,0,0,0,0,0,0,9,0,0,45,432,6018,477,0,0
21,3/31/2020,480,6330,0,0,0,0,0,0,0,11,0,0,41,751,6810,792,2,0
21,4/1/2020,591,6965,0,0,0,0,0,0,0,17,0,0,111,635,7556,746,6,0
21,4/2/2020,680,7220,0,0,0,0,0,0,0,20,0,0,89,255,7900,344,3,0
21,4/3/2020,770,12034,0,0,0,0,0,0,0,31,0,0,90,4814,12804,4904,11,0
21,4/4/2020,831,14741,0,0,0,0,0,0,0,37,0,0,61,2707,15572,2768,6,0
21,4/5/2020,917,15746,0,0,0,0,0,0,0,40,0,0,86,1005,16663,1091,3,0
21,4/6/2020,955,17812,0,0,0,0,0,0,0,45,0,0,38,2066,18767,2104,5,0
21,4/7/2020,1008,18947,0,0,0,0,0,0,0,59,0,0,53,1135,19955,1188,14,0
21,4/8/2020,1149,20455,0,0,0,0,0,0,0,65,0,0,141,1508,21604,1649,6,0
21,4/9/2020,1346,20455,0,0,0,0,0,0,0,73,0,0,197,0,21801,197,8,0
21,4/10/2020,1693,22595,271,459,105,177,0,0,464,90,0,0,347,2140,24288,2487,17,459
21,4/11/2020,1693,22595,271,459,105,177,0,0,464,90,0,0,0,0,24288,0,0,0
21,4/12/2020,1840,22727,271,459,105,177,0,0,464,94,0,0,147,132,24567,279,4,0
21,4/13/2020,1963,23903,289,667,136,256,0,0,607,97,0,0,123,1176,25866,1299,3,208
21,4/14/2020,2048,24635,299,673,136,259,0,0,629,104,0,0,85,732,26683,817,7,6
21,4/15/2020,2210,25487,305,687,137,263,0,0,653,115,0,0,162,852,27697,1014,11,14
21,4/16/2020,2291,26033,412,807,252,367,0,0,862,122,0,0,81,546,28324,627,7,120
21,4/17/2020,2429,27318,477,971,333,506,0,0,956,129,0,0,138,1285,29747,1423,7,164
21,4/18/2020,2522,28074,360,1008,227,514,0,0,979,137,0,0,93,756,30596,849,8,37
21,4/19/2020,2707,29518,274,1059,155,534,0,0,1174,144,0,0,185,1444,32225,1629,7,51
21,4/20/2020,2960,29612,274,1059,155,534,0,0,1174,148,0,0,253,94,32572,347,4,0
21,4/21/2020,3050,29770,263,1059,147,582,0,0,1174,154,0,0,90,158,32820,248,6,0
21,4/22/2020,3192,30136,286,1076,165,558,0,0,1266,171,0,0,142,366,33328,508,17,17
21,4/23/2020,3373,32702,301,1105,161,564,0,0,1311,185,0,0,181,2566,36075,2747,14,29
21,4/24/2020,3481,39363,302,1115,163,570,0,0,1335,191,0,0,108,6661,42844,6769,6,10
21,4/25/2020,3779,41183,303,1143,164,575,0,0,1341,200,0,0,298,1820,44962,2118,9,28
21,4/26/2020,3905,42653,301,1266,164,605,0,0,1501,205,0,0,126,1470,46558,1596,5,123
21,4/27/2020,4074,44400,308,1274,166,608,0,0,1511,208,0,0,169,1747,48474,1916,3,8
21,4/28/2020,4146,44653,313,1281,165,612,0,0,1521,213,0,0,72,253,48799,325,5,7
21,4/29/2020,4375,48036,320,1331,170,625,0,0,1617,225,0,0,229,3383,52411,3612,12,50
21,4/30/2020,4539,49562,325,1359,176,636,0,0,1668,235,0,0,164,1526,54101,1690,10,28
21,5/1/2020,4708,51904,330,1375,178,642,0,0,1675,240,0,0,169,2342,56612,2511,5,16
21,5/2/2020,4879,52770,334,1411,178,652,0,0,1752,248,0,0,171,866,57649,1037,8,36
21,5/3/2020,4879,52770,334,1411,178,652,0,0,1752,248,212,0,0,0,57649,0,0,0
21,5/4/2020,5130,53279,329,1519,170,654,0,0,1892,253,0,0,251,509,58409,760,5,108
21,5/5/2020,5245,54802,333,1529,174,659,0,0,1892,261,0,0,115,1523,60047,1638,8,10
21,5/6/2020,5822,55192,347,1603,189,685,0,0,2058,275,0,0,577,390,61014,967,14,74
21,5/7/2020,5934,72672,351,1616,190,693,0,0,2125,283,0,0,112,17480,78606,17592,8,13
21,5/8/2020,6129,75272,356,1684,199,714,0,0,2177,294,0,0,195,2600,81401,2795,11,68
21,5/9/2020,6288,80159,369,1696,210,723,0,0,2266,298,0,0,159,4887,86447,5046,4,12
21,5/10/2020,6440,80483,394,1757,226,758,0,0,2308,304,0,0,152,324,86923,476,6,61
21,5/11/2020,6440,80483,394,1757,226,758,0,0,2308,304,0,0,0,0,86923,0,0,0
21,5/12/2020,6677,97347,383,1767,220,768,0,0,2335,311,311,0,237,16864,104024,17101,7,10
21,5/13/2020,6853,103781,379,1825,215,783,0,0,2546,321,321,0,176,6434,110634,6610,10,58
21,5/14/2020,7080,110315,377,1835,215,784,0,0,2649,326,326,0,227,6534,117395,6761,5,10
21,5/15/2020,7225,114053,385,1887,220,794,0,0,2712,328,328,0,145,3738,121278,3883,2,52
21,5/16/2020,7444,120290,381,1896,218,797,0,0,2739,332,332,0,219,6237,127734,6456,4,9
21,5/17/2020,7688,121997,381,1896,218,797,0,0,2768,334,334,0,244,1707,129685,1951,2,0
21,5/18/2020,7688,121997,381,1896,218,797,0,0,2768,334,334,0,0,0,129685,0,0,0
21,5/19/2020,8069,145917,447,1980,277,866,0,0,2826,366,345,1,381,23920,153986,24301,32,84
21,5/20/2020,8069,145917,443,2010,269,875,0,0,2826,366,365,1,0,0,153986,0,0,30
21,5/21/2020,8167,150505,474,2016,98,879,0,0,2919,376,375,1,98,4588,158672,4686,10,6
21,5/22/2020,8286,157954,475,2041,92,886,0,0,3008,386,385,1,119,7449,166240,7568,10,25
21,5/23/2020,8426,163033,477,2076,90,889,0,0,3069,391,390,1,140,5079,171459,5219,5,35
21,5/24/2020,8571,161285,484,2131,89,897,0,0,3102,391,390,1,145,-1748,169856,-1603,0,55
21,5/25/2020,8571,161285,484,2131,89,897,0,0,3102,391,390,1,0,0,169856,0,0,0
21,5/26/2020,8571,161285,484,2131,89,897,0,0,3102,391,390,1,0,0,169856,0,0,0
21,5/27/2020,9077,173024,489,2136,78,897,0,0,3124,400,399,1,506,11739,182101,12245,9,5
21,5/28/2020,9077,173024,512,2142,82,899,0,0,3124,400,399,1,0,0,182101,0,0,6
21,5/29/2020,9184,212090,494,2180,88,937,0,0,3181,409,408,1,107,39066,221274,39173,9,38
21,5/30/2020,9464,198731,499,2266,81,940,0,0,3231,418,417,1,280,-13359,208195,-13079,9,86
21,5/31/2020,9704,204049,480,2272,87,940,0,0,3232,431,430,1,240,5318,213753,5558,13,6
21,6/1/2020,10046,206000,457,2274,90,940,0,0,3232,439,438,1,342,1951,216046,2293,8,2
21,6/2/2020,10185,217086,481,2307,85,941,0,0,3275,442,441,1,139,11086,227271,11225,3,33
21,6/3/2020,10410,221789,488,2317,68,950,0,0,3283,450,449,1,225,4703,232199,4928,8,10
21,6/4/2020,10705,225220,518,2332,67,954,0,0,3303,458,456,2,295,3431,235925,3726,8,15
21,6/5/2020,10977,231440,505,2345,73,958,0,0,3316,466,465,1,272,6220,242417,6492,8,13
21,6/6/2020,11287,237775,495,2361,75,958,0,0,3344,470,468,2,310,6335,249062,6645,4,16
21,6/7/2020,11287,237775,495,2361,75,958,0,0,3344,470,468,2,0,0,249062,0,0,0
21,6/8/2020,11476,241381,486,2368,76,958,0,0,3359,472,470,2,189,3606,252857,3795,2,7
21,6/9/2020,11708,248230,525,2386,75,966,0,0,3365,477,475,2,232,6849,259938,7081,5,18
21,6/10/2020,11883,262531,508,2396,68,966,0,0,3375,484,482,2,175,14301,274414,14476,7,10
21,6/11/2020,11945,269149,514,2406,81,967,0,0,3379,493,491,2,62,6618,281094,6680,9,10
21,6/12/2020,11945,269149,514,2406,81,967,0,0,3379,493,491,2,0,0,281094,0,0,0
21,6/13/2020,12445,282140,410,2433,68,969,0,0,3409,499,497,2,500,12991,294585,13491,6,27
21,6/14/2020,12445,282140,410,2433,68,969,0,0,3409,499,497,2,0,0,294585,0,0,0
21,6/15/2020,12647,283204,383,2433,63,969,0,0,3416,505,503,2,202,1064,295851,1266,6,0
21,6/16/2020,12829,283204,395,2436,69,969,0,0,3431,512,510,2,182,0,296033,182,7,3
21,6/17/2020,12995,286874,416,2455,61,971,0,0,3444,518,516,2,166,3670,299869,3836,6,19
21,6/18/2020,13197,293183,400,2482,68,975,0,0,3506,520,518,2,202,6309,306380,6511,2,27
21,6/19/2020,13454,297773,339,2494,64,978,0,0,3516,522,519,3,257,4590,311227,4847,2,12
21,6/20/2020,13630,303531,354,2522,62,980,0,0,3530,524,521,3,176,5758,317161,5934,2,28
21,6/21/2020,13750,303531,354,2522,62,980,0,0,3530,526,523,3,120,0,317281,120,2,0
21,6/22/2020,13839,308193,349,2532,67,987,0,0,3534,526,522,4,89,4662,322032,4751,0,10
21,6/23/2020,14141,317153,376,2556,70,988,0,0,3591,537,533,4,302,8960,331294,9262,11,24
21,6/24/2020,14363,321339,335,2574,79,992,0,0,3706,538,534,4,222,4186,335702,4408,1,18
21,6/25/2020,14617,328265,377,2584,79,994,0,0,3719,546,542,4,254,6926,342882,7180,8,10
21,6/26/2020,14859,335895,387,2589,74,996,0,0,3730,553,550,3,242,7630,350754,7872,7,5
21,6/27/2020,14859,335895,387,2589,74,996,0,0,3730,553,550,3,0,0,350754,0,0,0
21,6/28/2020,15232,343259,386,2590,68,996,0,0,3730,558,555,3,373,7364,358491,7737,5,1
21,6/29/2020,15347,346094,381,2602,69,999,0,0,3939,560,557,3,115,2835,361441,2950,2,12
21,6/30/2020,15624,355310,408,2621,75,1019,0,0,3990,565,561,4,277,9216,370934,9493,5,19
21,7/1/2020,15842,361248,427,2635,73,1007,0,0,4052,572,568,4,218,5938,377090,6156,7,14
21,7/2/2020,16079,369715,430,2662,73,994,0,0,4726,581,577,4,237,8467,385794,8704,9,27
21,7/3/2020,16376,379271,455,2685,99,996,0,0,4747,585,581,4,297,9556,395647,9853,4,23
21,7/4/2020,16376,379271,455,2685,99,996,0,0,4747,585,581,4,0,0,395647,0,0,0
21,7/5/2020,16376,379271,455,2685,99,996,0,0,4747,585,581,4,0,0,395647,0,0,0
21,7/6/2020,17152,383190,433,2699,109,1000,0,0,4785,593,589,4,776,3919,400342,4695,8,14
21,7/7/2020,17519,392353,421,2708,110,1003,0,0,4841,602,598,4,367,9163,409872,9530,9,9
21,7/8/2020,17919,398002,453,2737,111,1007,0,0,4912,608,604,4,400,5649,415921,6049,6,29
21,7/9/2020,18245,405768,457,2747,105,1007,0,0,4939,612,608,4,326,7766,424013,8092,4,10
21,7/10/2020,18670,414020,409,2763,70,1012,0,0,5258,620,616,4,425,8252,432690,8677,8,16
21,7/11/2020,19121,418781,370,2779,75,1014,0,0,5322,622,618,4,451,4761,437902,5212,2,16
21,7/12/2020,19389,418781,370,2779,75,1014,0,0,5322,625,621,4,268,0,438170,268,3,0
21,7/13/2020,19653,422232,440,2791,87,1017,0,0,5344,629,625,4,264,3451,441885,3715,4,12
21,7/14/2020,20223,435333,449,2802,84,1019,0,0,5389,635,631,4,570,13101,455556,13671,6,11
21,7/15/2020,20677,438510,445,2823,92,1028,0,0,5475,645,641,4,454,3177,459187,3631,10,21
21,7/16/2020,21083,446921,418,2842,92,1030,0,0,5500,650,646,4,406,8411,468004,8817,5,19
21,7/17/2020,21605,461457,452,2864,89,1031,0,0,6772,658,653,5,522,14536,483062,15058,8,22
22,3/7/2020,0,0,0,0,0,0,0,0,0,0,0,0,0,0,0,0,0,0
22,3/8/2020,0,5,0,0,0,0,0,0,0,0,0,0,0,5,5,5,0,0
22,3/9/2020,1,5,0,0,0,0,0,0,0,0,0,0,1,0,6,1,0,0
22,3/10/2020,1,11,0,0,0,0,0,0,0,0,0,0,0,6,12,6,0,0
22,3/11/2020,6,37,0,0,0,0,0,0,0,0,0,0,5,26,43,31,0,0
22,3/12/2020,14,37,0,0,0,0,0,0,0,0,0,0,8,0,51,8,0,0
22,3/13/2020,36,37,0,0,0,0,0,0,0,0,0,0,22,0,73,22,0,0
22,3/14/2020,51,109,0,0,0,0,0,0,0,0,0,0,15,72,160,87,0,0
22,3/15/2020,90,156,0,0,0,0,0,0,0,2,0,0,39,47,246,86,2,0
22,3/16/2020,115,188,0,0,0,0,0,0,0,2,0,0,25,32,303,57,0,0
22,3/17/2020,137,286,0,0,0,0,0,0,0,4,0,0,22,98,423,120,2,0
22,3/18/2020,240,335,0,0,0,0,0,0,0,6,0,0,103,49,575,152,2,0
22,3/19/2020,347,458,0,0,0,0,0,0,0,8,0,0,107,123,805,230,2,0
22,3/20/2020,473,568,0,0,0,0,0,0,0,12,0,0,126,110,1041,236,4,0
22,3/21/2020,580,2180,0,0,0,0,0,0,0,16,0,0,107,1612,2760,1719,4,0
22,3/22/2020,837,2661,0,0,0,0,0,0,0,20,0,0,257,481,3498,738,4,0
22,3/23/2020,1172,4776,0,0,0,0,0,0,0,34,0,0,335,2115,5948,2450,14,0
22,3/24/2020,1388,7215,271,0,0,0,0,0,0,46,0,0,216,2439,8603,2655,12,0
22,3/25/2020,1795,9656,491,0,0,0,163,0,0,65,0,0,407,2441,11451,2848,19,0
22,3/26/2020,2305,15724,676,0,0,0,239,0,0,83,0,0,510,6068,18029,6578,18,0
22,3/27/2020,2746,18613,773,0,0,0,270,0,0,119,0,0,441,2889,21359,3330,36,0
22,3/28/2020,3315,21846,927,0,0,0,336,0,0,137,0,0,569,3233,25161,3802,18,0
22,3/29/2020,3540,24331,1127,0,0,0,380,0,0,151,0,0,225,2485,27871,2710,14,0
22,3/30/2020,4025,30008,1185,0,0,0,385,0,0,185,0,0,485,5677,34033,6162,34,0
22,3/31/2020,5237,33730,1355,0,0,0,438,0,0,239,0,0,1212,3722,38967,4934,54,0
22,4/1/2020,6424,39352,1498,0,0,0,490,0,0,273,0,0,1187,5622,45776,6809,34,0
22,4/2/2020,9150,41936,1639,0,0,0,507,0,0,310,0,0,2726,2584,51086,5310,37,0
22,4/3/2020,10297,43348,1707,0,0,0,535,0,0,370,0,0,1147,1412,53645,2559,60,0
22,4/4/2020,12496,46002,1726,0,0,0,571,0,0,409,0,0,2199,2654,58498,4853,39,0
22,4/5/2020,13010,47315,1803,0,0,0,561,0,0,477,0,0,514,1313,60325,1827,68,0
22,4/6/2020,14867,54299,1981,0,0,0,552,0,0,512,0,0,1857,6984,69166,8841,35,0
22,4/7/2020,16284,58371,1996,0,0,0,519,0,0,582,0,0,1417,4072,74655,5489,70,0
22,4/8/2020,17030,64376,1983,0,0,0,490,0,0,652,0,0,746,6005,81406,6751,70,0
22,4/9/2020,18283,68636,2014,0,0,0,473,0,0,702,0,0,1253,4260,86919,5513,50,0
22,4/10/2020,19253,73027,2054,0,0,0,479,0,0,755,0,0,970,4391,92280,5361,53,0
22,4/11/2020,20014,76901,2067,0,0,0,470,0,0,806,0,0,761,3874,96915,4635,51,0
22,4/12/2020,20595,83450,2084,0,0,0,458,0,0,840,0,0,581,6549,104045,7130,34,0
22,4/13/2020,21016,87075,2134,0,0,0,461,0,0,884,0,0,421,3625,108091,4046,44,0
22,4/14/2020,21518,96904,1977,0,0,0,436,0,0,1013,0,0,502,9829,118422,10331,129,0
22,4/15/2020,21951,99977,1943,0,0,0,425,0,0,1103,0,0,433,3073,121928,3506,90,0
22,4/16/2020,22532,104054,1914,0,0,0,396,0,0,1156,0,0,581,4077,126586,4658,53,0
22,4/17/2020,23118,108869,1868,0,0,0,363,0,0,1213,0,0,586,4815,131987,5401,57,0
22,4/18/2020,23580,114419,1761,0,0,0,347,0,0,1267,0,0,462,5550,137999,6012,54,0
22,4/19/2020,23928,111420,1748,0,0,0,349,0,0,1296,0,0,348,-2999,135348,-2651,29,0
22,4/20/2020,24523,111588,1794,0,0,0,332,0,0,1328,0,0,595,168,136111,763,32,0
22,4/21/2020,24854,111588,1798,0,0,0,297,0,0,1405,0,0,331,0,136442,331,77,0
22,4/22/2020,25258,111588,1747,0,0,0,287,0,14927,1473,0,0,404,0,136846,404,68,0
22,4/23/2020,25739,111774,1727,0,0,0,274,0,14927,1540,0,0,481,186,137513,667,67,0
22,4/24/2020,26140,111972,1697,0,0,0,286,0,14927,1601,0,0,401,198,138112,599,61,0
22,4/25/2020,26512,112490,1700,0,0,0,268,0,14927,1644,0,0,372,518,139002,890,43,0
22,4/26/2020,26773,116263,1701,0,0,0,265,0,14927,1670,0,0,261,3773,143036,4034,26,0
22,4/27/2020,27068,119921,1683,0,0,0,262,0,17303,1697,1599,0,295,3658,146989,3953,27,0
22,4/28/2020,27286,123822,1666,0,0,0,244,0,17303,1758,1660,0,218,3901,151108,4119,61,0
22,4/29/2020,27660,128908,1629,0,0,0,244,0,17303,1802,1703,0,374,5086,156568,5460,44,0
22,4/30/2020,28001,133308,1601,0,0,0,231,0,17303,1862,1729,0,341,4400,161309,4741,60,0
22,5/1/2020,28711,139540,1607,0,0,0,230,0,17303,1927,1740,0,710,6232,168251,6942,65,0
22,5/2/2020,29140,143718,1545,0,0,0,208,0,17303,1950,1801,0,429,4178,172858,4607,23,0
22,5/3/2020,29340,146820,1530,0,0,0,213,0,17303,1969,1845,0,200,3102,176160,3302,19,0
22,5/4/2020,29673,151258,1502,0,0,0,220,0,20316,2064,1905,0,333,4438,180931,4771,95,0
22,5/5/2020,29996,158235,1512,0,0,0,194,0,20316,2115,1884,0,323,6977,188231,7300,51,0
22,5/6/2020,30399,164273,1465,0,0,0,187,0,20316,2115,1907,0,403,6038,194672,6441,0,0
22,5/7/2020,30652,170115,1432,0,0,0,189,0,20316,2208,1926,0,253,5842,200767,6095,93,0
22,5/8/2020,30855,171561,1359,0,0,0,185,0,20316,2227,1991,0,203,1446,202416,1649,19,0
22,5/9/2020,31417,180740,1333,0,0,0,165,0,20316,2267,2042,0,562,9179,212157,9741,40,0
22,5/10/2020,31600,184272,1324,0,0,0,161,0,20316,2286,0,0,183,3532,215872,3715,19,0
22,5/11/2020,31815,189015,1310,0,0,0,157,0,22608,2308,0,0,215,4743,220830,4958,22,0
22,5/12/2020,32050,195962,1320,0,0,0,146,0,22608,2347,2281,66,235,6947,228012,7182,39,0
22,5/13/2020,32662,205242,1194,0,0,0,147,0,22608,2381,2315,66,612,9280,237904,9892,34,0
22,5/14/2020,33489,214099,1193,0,0,0,140,0,22608,2417,2351,66,827,8857,247588,9684,36,0
22,5/15/2020,33837,219352,1091,0,0,0,132,0,22608,2448,2382,66,348,5253,253189,5601,31,0
22,5/16/2020,34117,225625,1028,0,0,0,123,0,22608,2479,2413,66,280,6273,259742,6553,31,0
22,5/17/2020,34432,230738,1019,0,0,0,111,0,22608,2491,2425,66,315,5113,265170,5428,12,0
22,5/18/2020,34709,235039,1031,0,0,0,118,0,26249,2563,2440,123,277,4301,269748,4578,72,0
22,5/19/2020,35038,243035,1004,0,0,0,112,0,26249,2581,2458,123,329,7996,278073,8325,18,0
22,5/20/2020,35316,250654,931,0,0,0,110,0,26249,2608,2485,123,278,7619,285970,7897,27,0
22,5/21/2020,36504,268877,884,0,0,0,107,0,26249,2629,2506,123,1188,18223,305381,19411,21,0
22,5/22/2020,36925,274883,867,0,0,0,104,0,26249,2668,2545,123,421,6006,311808,6427,39,0
22,5/23/2020,37040,277407,836,0,0,0,112,0,26249,2668,2560,123,115,2524,314447,2639,0,0
22,5/24/2020,37169,278867,813,0,0,0,102,0,26249,2690,2567,123,129,1460,316036,1589,22,0
22,5/25/2020,37809,293089,847,0,0,0,102,0,28700,2690,2585,105,640,14222,330898,14862,0,0
22,5/26/2020,38054,302972,831,0,0,0,103,0,28700,2701,2596,105,245,9883,341026,10128,11,0
22,5/27/2020,38497,309150,798,0,0,0,100,0,28700,2722,2617,105,443,6178,347647,6621,21,0
22,5/28/2020,38802,316225,761,0,0,0,100,0,28700,2740,2635,105,305,7075,355027,7380,18,0
22,5/29/2020,38802,316225,714,0,0,0,90,0,28700,2766,2661,105,0,0,355027,0,26,0
22,5/30/2020,39577,329242,674,0,0,0,84,0,28700,2785,2680,105,775,13017,368819,13792,19,0
22,5/31/2020,39916,335193,678,0,0,0,84,0,28700,2791,2686,105,339,5951,375109,6290,6,0
22,6/1/2020,40341,347029,661,0,0,0,86,0,31728,2801,2690,111,425,11836,387370,12261,10,0
22,6/2/2020,40746,352387,639,0,0,0,83,0,31728,2835,2724,111,405,5358,393133,5763,34,0
22,6/3/2020,41133,360954,617,0,0,0,86,0,31728,2870,2759,111,387,8567,402087,8954,35,0
22,6/4/2020,41562,369624,613,0,0,0,82,0,31728,2883,2772,111,429,8670,411186,9099,13,0
22,6/5/2020,41989,378797,604,0,0,0,75,0,31728,2912,2801,111,427,9173,420786,9600,29,0
22,6/6/2020,42486,385583,582,0,0,0,77,0,31728,2925,2814,111,497,6786,428069,7283,13,0
22,6/7/2020,42816,391249,575,0,0,0,74,0,31728,2936,2825,111,330,5666,434065,5996,11,0
22,6/8/2020,43050,399552,582,0,0,0,71,0,33904,2944,2831,113,234,8303,442602,8537,8,0
22,6/9/2020,43612,410056,568,0,0,0,67,0,33904,2957,2844,113,562,10504,453668,11066,13,0
22,6/10/2020,44030,416090,549,0,0,0,72,0,33904,2968,2855,113,418,6034,460120,6452,11,0
22,6/11/2020,44472,425201,553,0,0,0,77,0,33904,2987,2874,113,442,9111,469673,9553,19,0
22,6/12/2020,44995,434539,549,0,0,0,74,0,33904,2996,2883,113,523,9338,479534,9861,9,0
22,6/13/2020,46283,458100,542,0,0,0,76,0,33904,3004,2891,113,1288,23561,504383,24849,8,0
22,6/14/2020,46619,462713,556,0,0,0,76,0,33904,3014,2901,113,336,4613,509332,4949,10,0
22,6/15/2020,47172,471553,568,0,0,0,76,0,37017,3018,2906,112,553,8840,518725,9393,4,0
22,6/16/2020,47706,485011,588,0,0,0,77,0,37017,3042,2930,112,534,13458,532717,13992,24,0
22,6/17/2020,48634,496587,585,0,0,0,83,0,37017,3062,2950,112,928,11576,545221,12504,20,0
22,6/18/2020,48634,496587,585,0,0,0,83,0,37017,3062,2950,112,0,0,545221,0,0,0
22,6/19/2020,48515,542394,561,0,0,0,75,0,37017,3084,2972,112,-119,45807,590909,45688,22,0
22,6/20/2020,49385,555431,574,0,0,0,73,0,37017,3104,2992,112,870,13037,604816,13907,20,0
22,6/21/2020,49778,561034,589,0,0,0,69,0,37017,3105,2993,112,393,5603,610812,5996,1,0
22,6/22/2020,50239,567825,630,0,0,0,77,0,39792,3117,3004,113,461,6791,618064,7252,12,0
22,6/23/2020,51595,584344,646,0,0,0,83,0,39792,3134,3021,113,1356,16519,635939,17875,17,0
22,6/24/2020,52477,596028,631,0,0,0,77,0,39792,3152,3039,113,882,11684,648505,12566,18,0
22,6/25/2020,53415,607250,653,0,0,0,77,0,39792,3164,3051,113,938,11222,660665,12160,12,0
22,6/26/2020,54769,623237,700,0,0,0,73,0,39792,3190,3077,113,1354,15987,678006,17341,26,0
22,6/27/2020,54769,623237,700,0,0,0,73,0,39792,3190,3077,113,0,0,678006,0,0,0
22,6/28/2020,56236,639875,715,0,0,0,76,0,39792,3199,3086,113,1467,16638,696111,18105,9,0
22,6/29/2020,57081,647556,737,0,0,0,79,0,42225,3199,3091,108,845,7681,704637,8526,0,0
22,6/30/2020,58095,670416,781,0,0,0,83,0,42225,3221,3113,108,1014,22860,728511,23874,22,0
22,7/1/2020,60178,691910,799,0,0,0,84,0,43026,3238,3130,108,2083,21494,752088,23577,17,0
22,7/2/2020,61561,705813,840,0,0,0,91,0,43026,3255,3147,108,1383,13903,767374,15286,17,0
22,7/3/2020,63289,720853,852,0,0,0,93,0,43026,3278,3170,108,1728,15040,784142,16768,23,0
22,7/4/2020,63289,720853,852,0,0,0,93,0,43026,3278,3170,108,0,0,784142,0,0,0
22,7/5/2020,65226,737228,926,0,0,0,105,0,43026,3288,3180,108,1937,16375,802454,18312,10,0
22,7/6/2020,66327,747318,964,0,0,0,109,0,43026,3296,3188,108,1101,10090,813645,11191,8,0
22,7/7/2020,68263,779335,1025,0,0,0,109,0,43026,3319,3211,108,1936,32017,847598,33953,23,0
22,7/8/2020,70151,795586,1022,0,0,0,105,0,46334,3339,3231,108,1888,16251,865737,18139,20,0
22,7/9/2020,71994,808146,1042,0,0,0,110,0,46334,3355,3247,108,1843,12560,880140,14403,16,0
22,7/10/2020,74636,830612,1117,0,0,0,122,0,46334,3380,3272,108,2642,22466,905248,25108,25,0
22,7/11/2020,76803,847644,1182,0,0,0,121,0,46334,3403,3295,108,2167,17032,924447,19199,23,0
22,7/12/2020,78122,856873,1243,0,0,0,134,0,46334,3416,3308,108,1319,9229,934995,10548,13,0
22,7/13/2020,79827,873599,1308,0,0,0,142,0,46334,3423,3315,108,1705,16726,953426,18431,7,0
22,7/14/2020,82042,894413,1362,0,0,0,146,0,46334,3445,3337,108,2215,20814,976455,23029,22,0
22,7/15/2020,84131,917069,1369,0,0,0,149,0,53288,3461,3351,110,2089,22656,1001200,24745,16,0
22,7/16/2020,86411,937726,1401,0,0,0,162,0,53288,3485,3375,110,2280,20657,1024137,22937,24,0
22,7/17/2020,88590,955350,1413,0,0,0,161,0,53288,3509,3399,110,2179,17624,1043940,19803,24,0
23,3/7/2020,0,1,0,0,0,0,0,0,0,0,0,0,0,0,1,0,0,0
23,3/8/2020,0,1,0,0,0,0,0,0,0,0,0,0,0,0,1,0,0,0
23,3/9/2020,0,1,0,0,0,0,0,0,0,0,0,0,0,0,1,0,0,0
23,3/10/2020,0,20,0,0,0,0,0,0,0,0,0,0,0,19,20,19,0,0
23,3/11/2020,0,42,0,0,0,0,0,0,0,0,0,0,0,22,42,22,0,0
23,3/12/2020,1,65,0,0,0,0,0,0,0,0,0,0,1,23,66,24,0,0
23,3/13/2020,3,91,0,0,0,0,0,0,0,0,0,0,2,26,94,28,0,0
23,3/14/2020,3,91,0,0,0,0,0,0,0,0,0,0,0,0,94,0,0,0
23,3/15/2020,3,91,0,0,0,0,0,0,0,0,0,0,0,0,94,0,0,0
23,3/16/2020,17,764,0,0,0,0,0,0,0,0,0,0,14,673,781,687,0,0
23,3/17/2020,32,1303,0,0,0,0,0,0,0,0,0,0,15,539,1335,554,0,0
23,3/18/2020,43,1670,0,0,0,0,0,0,0,0,0,0,11,367,1713,378,0,0
23,3/19/2020,53,2004,0,0,0,0,0,0,0,0,0,0,10,334,2057,344,0,0
23,3/20/2020,57,2264,0,0,0,0,0,0,0,0,0,0,4,260,2321,264,0,0
23,3/21/2020,73,2264,0,0,0,0,0,0,0,0,0,0,16,0,2337,16,0,0
23,3/22/2020,89,2264,0,0,0,0,0,0,0,0,0,0,16,0,2353,16,0,0
23,3/23/2020,107,2791,0,0,0,0,0,0,0,0,0,0,18,527,2898,545,0,0
23,3/24/2020,125,3014,0,0,0,0,0,0,0,0,0,0,18,223,3139,241,0,0
23,3/25/2020,149,3177,0,0,0,0,0,0,7,0,0,0,24,163,3326,187,0,0
23,3/26/2020,155,3394,0,0,0,0,0,0,16,0,0,0,6,217,3549,223,0,0
23,3/27/2020,168,3394,0,0,0,0,0,0,24,1,0,0,13,0,3562,13,1,0
23,3/28/2020,211,3394,0,0,0,0,0,0,36,1,0,0,43,0,3605,43,0,0
23,3/29/2020,253,3394,0,0,0,0,0,0,41,3,0,0,42,0,3647,42,2,0
23,3/30/2020,275,3394,0,49,0,0,0,0,41,3,0,0,22,0,3669,22,0,49
23,3/31/2020,303,6088,0,57,0,0,0,0,68,5,0,0,28,2694,6391,2722,2,8
23,4/1/2020,344,6088,0,63,0,0,0,0,80,7,0,0,41,0,6432,41,2,6
23,4/2/2020,376,6088,0,68,0,0,0,0,94,7,0,0,32,0,6464,32,0,5
23,4/3/2020,432,6088,0,75,0,0,0,0,113,9,0,0,56,0,6520,56,2,7
23,4/4/2020,456,6088,0,83,0,0,0,0,140,10,0,0,24,0,6544,24,1,8
23,4/5/2020,470,6088,0,86,0,0,0,0,156,10,0,0,14,0,6558,14,0,3
23,4/6/2020,499,6088,0,92,0,0,0,0,158,10,0,0,29,0,6587,29,0,6
23,4/7/2020,519,6088,0,99,0,0,0,0,176,12,0,0,20,0,6607,20,2,7
23,4/8/2020,537,6088,0,101,0,0,0,0,187,14,0,0,18,0,6625,18,2,2
23,4/9/2020,560,6088,0,105,0,0,0,0,202,16,0,0,23,0,6648,23,2,4
23,4/10/2020,586,6088,0,111,0,0,0,0,246,17,0,0,26,0,6674,26,1,6
23,4/11/2020,616,6088,0,114,0,0,0,0,256,19,0,0,30,0,6704,30,2,3
23,4/12/2020,633,6088,0,120,0,0,0,0,266,19,0,0,17,0,6721,17,0,6
23,4/13/2020,698,11608,22,124,0,0,0,0,273,19,0,0,65,5520,12306,5585,0,4
23,4/14/2020,734,11608,58,124,21,0,9,0,292,20,0,0,36,0,12342,36,1,0
23,4/15/2020,770,14076,48,126,22,0,9,0,305,24,0,0,36,2468,14846,2504,4,2
23,4/16/2020,796,14076,47,130,20,0,7,0,333,27,0,0,26,0,14872,26,3,4
23,4/17/2020,827,14076,55,133,28,0,8,0,352,29,0,0,31,0,14903,31,2,3
23,4/18/2020,847,14076,49,136,20,0,12,0,382,32,0,0,20,0,14923,20,3,3
23,4/19/2020,867,14076,46,136,18,0,9,0,393,34,0,0,20,0,14943,20,2,0
23,4/20/2020,875,14076,39,138,16,0,9,0,414,35,0,0,8,0,14951,8,1,2
23,4/21/2020,888,14076,40,139,16,0,8,0,443,36,0,0,13,0,14964,13,1,1
23,4/22/2020,907,16784,42,144,18,0,10,0,455,39,0,0,19,2708,17691,2727,3,5
23,4/23/2020,937,16784,42,150,18,0,11,0,485,44,0,0,30,0,17721,30,5,6
23,4/24/2020,965,16784,39,152,17,0,7,0,499,47,0,0,28,0,17749,28,3,2
23,4/25/2020,990,16784,39,156,17,0,7,0,519,50,0,0,25,0,17774,25,3,4
23,4/26/2020,1015,16784,39,159,19,0,7,0,532,50,0,0,25,0,17799,25,0,3
23,4/27/2020,1023,16784,39,161,16,0,7,0,549,51,0,0,8,0,17807,8,1,2
23,4/28/2020,1040,16784,33,163,17,0,7,0,585,51,0,0,17,0,17824,17,0,2
23,4/29/2020,1056,19546,32,166,17,0,7,0,615,52,0,0,16,2762,20602,2778,1,3
23,4/30/2020,1095,19546,35,170,18,0,8,0,631,53,0,0,39,0,20641,39,1,4
23,5/1/2020,1123,19546,37,177,17,0,9,0,657,55,0,0,28,0,20669,28,2,7
23,5/2/2020,1152,19546,36,181,19,0,10,0,689,56,0,0,29,0,20698,29,1,4
23,5/3/2020,1185,19546,33,183,18,0,12,0,706,57,0,0,33,0,20731,33,1,2
23,5/4/2020,1205,19546,37,186,18,0,11,0,720,57,0,0,20,0,20751,20,0,3
23,5/5/2020,1226,19546,36,187,18,0,12,0,741,61,0,0,21,0,20772,21,4,1
23,5/6/2020,1254,22092,37,191,18,0,12,0,766,62,0,0,28,2546,23346,2574,1,4
23,5/7/2020,1330,22092,39,192,16,0,11,0,787,62,0,0,76,0,23422,76,0,1
23,5/8/2020,1374,22092,44,194,23,0,10,0,836,63,0,0,44,0,23466,44,1,2
23,5/9/2020,1408,22092,43,198,22,0,10,0,857,64,0,0,34,0,23500,34,1,4
23,5/10/2020,1436,22092,36,199,17,0,10,0,861,64,0,0,28,0,23528,28,0,1
23,5/11/2020,1462,22092,37,200,17,0,9,0,872,65,0,0,26,0,23554,26,1,1
23,5/12/2020,1477,22092,34,202,17,0,8,0,913,65,65,0,15,0,23569,15,0,2
23,5/13/2020,1515,22092,41,204,20,0,7,0,943,66,66,0,38,0,23607,38,1,2
23,5/14/2020,1565,22092,37,207,18,0,7,0,958,69,69,0,50,0,23657,50,3,3
23,5/15/2020,1603,22092,35,211,16,0,8,0,993,69,69,0,38,0,23695,38,0,4
23,5/16/2020,1648,22092,37,214,19,0,10,0,1012,70,70,0,45,0,23740,45,1,3
23,5/17/2020,1687,22092,37,216,16,0,11,0,1028,70,70,0,39,0,23779,39,0,2
23,5/18/2020,1713,22092,42,223,16,0,10,0,1053,71,71,0,26,0,23805,26,1,7
23,5/19/2020,1741,22092,44,225,19,0,11,0,1088,73,73,0,28,0,23833,28,2,2
23,5/20/2020,1819,35450,43,231,24,0,12,0,1100,73,73,0,78,13358,37269,13436,0,6
23,5/21/2020,1877,35450,41,235,21,0,12,0,1145,73,73,0,58,0,37327,58,0,4
23,5/22/2020,1948,35450,45,240,21,0,12,0,1192,75,75,0,71,0,37398,71,2,5
23,5/23/2020,2013,35450,50,243,26,0,11,0,1232,77,77,0,65,0,37463,65,2,3
23,5/24/2020,2055,35450,59,252,27,0,13,0,1263,78,78,0,42,0,37505,42,1,9
23,5/25/2020,2074,35450,59,257,27,0,13,0,1290,78,78,0,19,0,37524,19,0,5
23,5/26/2020,2109,35450,60,258,26,0,13,0,1318,79,79,0,35,0,37559,35,1,1
23,5/27/2020,2137,43480,59,260,25,0,14,0,1357,81,81,0,28,8030,45617,8058,2,2
23,5/28/2020,2189,43480,58,264,22,0,14,0,1402,84,84,0,52,0,45669,52,3,4
23,5/29/2020,2226,43480,53,270,18,0,12,0,1458,85,85,0,37,0,45706,37,1,6
23,5/30/2020,2282,47284,46,272,18,0,11,0,1505,89,89,0,56,3804,49566,3860,4,2
23,5/31/2020,2325,47284,49,283,18,0,10,0,1552,89,89,0,43,0,49609,43,0,11
23,6/1/2020,2349,47284,52,284,17,0,10,0,1586,89,89,0,24,0,49633,24,0,1
23,6/2/2020,2377,50591,48,287,16,0,10,0,1646,94,94,0,28,3307,52968,3335,5,3
23,6/3/2020,2418,50591,44,285,14,0,10,0,1699,95,95,0,41,0,53009,41,1,-2
23,6/4/2020,2446,53755,35,291,14,0,7,0,1739,95,95,0,28,3164,56201,3192,0,6
23,6/5/2020,2482,55050,35,293,13,0,7,0,1797,98,98,0,36,1295,57532,1331,3,2
23,6/6/2020,2524,56399,35,296,14,0,7,0,1845,98,98,0,42,1349,58923,1391,0,3
23,6/7/2020,2570,56399,34,298,15,0,7,0,1864,99,99,0,46,0,58969,46,1,2
23,6/8/2020,2588,59057,37,301,12,0,7,0,1891,99,99,0,18,2658,61645,2676,0,3
23,6/9/2020,2606,59814,29,302,10,0,7,0,1992,100,100,0,18,757,62420,775,1,1
23,6/10/2020,2637,61303,27,303,10,0,5,0,2023,100,100,0,31,1489,63940,1520,0,1
23,6/11/2020,2667,62790,29,308,12,0,5,0,2062,100,100,0,30,1487,65457,1517,0,5
23,6/12/2020,2721,64166,32,308,11,0,5,0,2105,100,100,0,54,1376,66887,1430,0,0
23,6/13/2020,2757,65593,29,313,10,0,4,0,2152,100,100,0,36,1427,68350,1463,0,5
23,6/14/2020,2793,67065,29,314,10,0,5,0,2173,100,100,0,36,1472,69858,1508,0,1
23,6/15/2020,2810,68161,31,317,11,0,4,0,2189,101,101,0,17,1096,70971,1113,1,3
23,6/16/2020,2819,69516,30,321,10,0,6,0,2233,101,101,0,9,1355,72335,1364,0,4
23,6/17/2020,2836,71182,27,323,10,0,5,0,2275,102,102,0,17,1666,74018,1683,1,2
23,6/18/2020,2878,71182,27,323,10,0,4,0,2300,102,102,0,42,0,74060,42,0,0
23,6/19/2020,2913,74248,26,328,11,0,5,0,2323,102,102,0,35,3066,77161,3101,0,5
23,6/20/2020,2938,76638,29,333,13,0,5,0,2380,102,102,0,25,2390,79576,2415,0,5
23,6/21/2020,2957,78033,26,336,11,0,5,0,2391,102,102,0,19,1395,80990,1414,0,3
23,6/22/2020,2971,78033,27,336,13,0,6,0,2409,102,102,0,14,0,81004,14,0,0
23,6/23/2020,2994,78713,24,339,12,0,6,0,2443,102,101,1,23,680,81707,703,0,3
23,6/24/2020,3017,82173,26,339,12,0,6,0,2490,103,102,1,23,3460,85190,3483,1,0
23,6/25/2020,3070,84528,25,343,10,0,7,0,2512,103,102,1,53,2355,87598,2408,0,4
23,6/26/2020,3102,86752,28,343,9,0,6,0,2542,103,102,1,32,2224,89854,2256,0,0
23,6/27/2020,3154,88778,24,345,7,0,5,0,2566,104,103,1,52,2026,91932,2078,1,2
23,6/28/2020,3191,90304,31,346,10,0,4,0,2577,104,103,1,37,1526,93495,1563,0,1
23,6/29/2020,3219,90304,31,347,8,0,4,0,2623,105,104,1,28,0,93523,28,1,1
23,6/30/2020,3253,91699,29,348,9,0,4,0,2646,105,104,1,34,1395,94952,1429,0,1
23,7/1/2020,3294,93947,29,351,8,0,3,0,2671,105,104,1,41,2248,97241,2289,0,3
23,7/2/2020,3328,97489,30,354,9,0,3,0,2698,105,104,1,34,3542,100817,3576,0,3
23,7/3/2020,3373,100076,27,358,9,0,3,0,2731,105,104,1,45,2587,103449,2632,0,4
23,7/4/2020,3397,102548,27,358,9,0,3,0,2751,107,106,1,24,2472,105945,2496,2,0
23,7/5/2020,3415,104517,25,359,9,0,3,0,2772,109,108,1,18,1969,107932,1987,2,1
23,7/6/2020,3423,106127,21,359,9,0,4,0,2787,109,108,1,8,1610,109550,1618,0,0
23,7/7/2020,3440,107466,22,360,9,0,4,0,2816,110,109,1,17,1339,110906,1356,1,1
23,7/8/2020,3460,109478,22,363,8,0,5,0,2856,110,109,1,20,2012,112938,2032,0,3
23,7/9/2020,3486,112272,16,365,7,0,4,0,2901,111,110,1,26,2794,115758,2820,1,2
23,7/10/2020,3499,114907,15,366,7,0,4,0,2931,111,110,1,13,2635,118406,2648,0,1
23,7/11/2020,3520,116370,16,368,7,0,4,0,2972,112,111,1,21,1463,119890,1484,1,2
23,7/12/2020,3539,118775,19,371,9,0,3,0,2994,114,113,1,19,2405,122314,2424,2,3
23,7/13/2020,3558,120404,18,372,8,0,3,0,3008,114,113,1,19,1629,123962,1648,0,1
23,7/14/2020,3566,121909,17,373,7,0,3,0,3062,114,113,1,8,1505,125475,1513,0,1
23,7/15/2020,3578,124353,12,373,9,0,4,0,3079,114,113,1,12,2444,127931,2456,0,0
23,7/16/2020,3598,126864,13,374,11,0,4,0,3094,114,113,1,20,2511,130462,2531,0,1
23,7/17/2020,3636,129809,12,375,11,0,5,0,3114,115,114,1,38,2945,133445,2983,1,1
24,3/5/2020,0,17,0,0,0,0,0,0,0,0,0,0,0,0,17,0,0,0
24,3/6/2020,3,26,0,0,0,0,0,0,0,0,0,0,3,9,29,12,0,0
24,3/7/2020,3,41,0,0,0,0,0,0,0,0,0,0,0,15,44,15,0,0
24,3/8/2020,3,52,0,0,0,0,0,0,0,0,0,0,0,11,55,11,0,0
24,3/9/2020,5,73,0,0,0,0,0,0,0,0,0,0,2,21,78,23,0,0
24,3/10/2020,6,89,0,0,0,0,0,0,0,0,0,0,1,16,95,17,0,0
24,3/11/2020,9,94,0,0,0,0,0,0,0,0,0,0,3,5,103,8,0,0
24,3/12/2020,12,94,0,0,0,0,0,0,0,0,0,0,3,0,106,3,0,0
24,3/13/2020,17,94,0,0,0,0,0,0,0,0,0,0,5,0,111,5,0,0
24,3/14/2020,26,94,0,0,0,0,0,0,0,0,0,0,9,0,120,9,0,0
24,3/15/2020,31,94,0,0,0,0,0,0,0,0,0,0,5,0,125,5,0,0
24,3/16/2020,37,94,0,0,0,0,0,0,0,2,0,0,6,0,131,6,2,0
24,3/17/2020,57,94,0,0,0,0,0,0,0,0,0,0,20,0,151,20,-2,0
24,3/18/2020,85,94,0,0,0,0,0,0,0,2,2,0,28,0,179,28,2,0
24,3/19/2020,107,94,0,0,0,0,0,0,0,2,2,0,22,0,201,22,0,0
24,3/20/2020,149,94,0,0,0,0,0,0,0,3,3,0,42,0,243,42,1,0
24,3/21/2020,190,94,0,0,0,0,0,0,0,3,3,0,41,0,284,41,0,0
24,3/22/2020,244,94,0,0,0,0,0,0,0,4,4,0,54,0,338,54,1,0
24,3/23/2020,288,94,0,0,0,0,0,0,0,4,4,0,44,0,382,44,0,0
24,3/24/2020,349,94,0,0,0,0,0,0,0,5,5,0,61,0,443,61,1,0
24,3/25/2020,423,94,0,0,0,0,0,0,0,5,5,0,74,0,517,74,0,0
24,3/26/2020,580,94,0,132,0,0,0,0,0,7,7,0,157,0,674,157,2,132
24,3/27/2020,774,94,0,173,0,0,0,0,25,10,10,0,194,0,868,194,3,41
24,3/28/2020,992,11516,0,226,0,0,0,0,0,17,17,0,218,11422,12508,11640,7,53
24,3/29/2020,1239,12354,0,277,0,0,0,0,0,24,23,1,247,838,13593,1085,7,51
24,3/30/2020,1413,13316,0,353,0,0,0,0,0,35,34,1,174,962,14729,1136,11,76
24,3/31/2020,1660,14868,0,429,0,0,0,0,0,43,42,1,247,1552,16528,1799,8,76
24,4/1/2020,1985,17233,0,522,0,0,0,0,0,52,50,2,325,2365,19218,2690,9,93
24,4/2/2020,2331,18890,0,582,0,0,0,0,81,64,60,4,346,1657,21221,2003,12,60
24,4/3/2020,2758,20932,0,664,0,0,0,0,159,84,79,5,427,2042,23690,2469,20,82
24,4/4/2020,3125,22485,0,821,0,0,0,0,159,101,94,7,367,1553,25610,1920,17,157
24,4/5/2020,3609,24728,0,936,0,0,0,0,159,122,115,7,484,2243,28337,2727,21,115
24,4/6/2020,4045,25572,0,1059,0,0,0,0,184,138,131,7,436,844,29617,1280,16,123
24,4/7/2020,4371,27256,0,1106,0,0,0,0,288,160,152,8,326,1684,31627,2010,22,47
24,4/8/2020,5529,32933,0,1210,0,0,0,0,365,191,181,10,1158,5677,38462,6835,31,104
24,4/9/2020,6185,35344,0,1348,0,0,0,0,376,221,210,11,656,2411,41529,3067,30,138
24,4/10/2020,6968,37480,0,1413,0,0,0,0,397,255,244,11,783,2136,44448,2919,34,65
24,4/11/2020,7694,39544,0,1709,0,0,0,0,431,298,286,12,726,2064,47238,2790,43,296
24,4/12/2020,8225,41539,0,1860,0,0,0,0,456,335,317,18,531,1995,49764,2526,37,151
24,4/13/2020,8936,42815,0,1975,0,0,0,0,603,384,360,24,711,1276,51751,1987,49,115
24,4/14/2020,9472,44261,0,2122,0,0,0,0,607,421,396,25,536,1446,53733,1982,37,147
24,4/15/2020,10032,45731,0,2231,0,0,0,0,607,469,441,28,560,1470,55763,2030,48,109
24,4/16/2020,10784,48059,0,2451,0,0,0,0,736,499,471,28,752,2328,58843,3080,30,220
24,4/17/2020,11572,50437,0,2612,0,0,0,0,736,541,512,29,788,2378,62009,3166,42,161
24,4/18/2020,12308,53062,0,2757,0,0,0,0,771,582,550,32,736,2625,65370,3361,41,145
24,4/19/2020,12830,55061,0,2886,0,0,0,0,914,626,592,34,522,1999,67891,2521,44,129
24,4/20/2020,13684,57713,0,3014,0,0,0,0,917,683,644,39,854,2652,71397,3506,57,128
24,4/21/2020,14193,59442,1433,3158,526,0,0,0,930,732,692,40,509,1729,73635,2238,49,144
24,4/22/2020,14775,61754,1432,3325,527,0,0,0,981,779,738,41,582,2312,76529,2894,47,167
24,4/23/2020,15737,64363,1405,3477,515,0,0,0,1040,831,789,42,962,2609,80100,3571,52,152
24,4/24/2020,16616,68100,1425,3618,547,0,0,0,1108,899,853,46,879,3737,84716,4616,68,141
24,4/25/2020,17766,71357,1408,3760,538,0,0,0,1165,948,900,48,1150,3257,89123,4407,49,142
24,4/26/2020,18581,78084,1463,3962,530,0,0,0,1177,1001,950,51,815,6727,96665,7542,53,202
24,4/27/2020,19487,85489,1513,4101,535,0,0,0,1263,1045,990,55,906,7405,104976,8311,44,139
24,4/28/2020,20113,87672,1528,4268,551,0,0,0,1295,1099,1042,57,626,2183,107785,2809,54,167
24,4/29/2020,20849,90080,1610,4402,586,0,0,0,1361,1168,1110,58,736,2408,110929,3144,69,134
24,4/30/2020,21742,92617,1711,4559,590,0,0,0,1432,1226,1167,59,893,2537,114359,3430,58,157
24,5/1/2020,23472,97511,1668,4718,568,0,0,0,1517,1276,1214,62,1730,4894,120983,6624,50,159
24,5/2/2020,24473,101049,1657,4910,566,0,0,0,1590,1323,1258,65,1001,3538,125522,4539,47,192
24,5/3/2020,25462,107332,1635,5051,565,0,0,0,1666,1372,1302,70,989,6283,132794,7272,49,141
24,5/4/2020,26408,110587,1649,5199,563,0,0,0,1695,1424,1353,71,946,3255,136995,4201,52,148
24,5/5/2020,27117,112986,1693,5337,573,0,0,0,1810,1476,1402,74,709,2399,140103,3108,52,138
24,5/6/2020,28163,115849,1707,5497,584,0,0,0,1903,1520,1444,76,1046,2863,144012,3909,44,160
24,5/7/2020,29374,119226,1683,5663,584,0,0,0,2029,1580,1500,80,1211,3377,148600,4588,60,166
24,5/8/2020,30485,121702,1674,5811,571,0,0,0,2041,1643,1561,82,1111,2476,152187,3587,63,148
24,5/9/2020,31534,124494,1665,5932,575,0,0,0,2159,1692,1609,83,1049,2792,156028,3841,49,121
24,5/10/2020,32587,127344,1640,5955,611,0,0,0,2293,1739,1652,87,1053,2850,159931,3903,47,23
24,5/11/2020,33373,131407,1544,6183,585,0,0,0,2298,1788,1698,90,786,4063,164780,4849,49,228
24,5/12/2020,34061,135442,1563,6287,590,0,0,0,2394,1834,1742,92,688,4035,169503,4723,46,104
24,5/13/2020,34812,138762,1550,6404,572,0,0,0,2456,1881,1787,94,751,3320,173574,4071,47,117
24,5/14/2020,35903,142551,1538,6553,569,0,0,0,2569,1935,1840,95,1091,3789,178454,4880,54,149
24,5/15/2020,36986,145840,1496,6679,598,0,0,0,2685,1991,1896,95,1083,3289,182826,4372,56,126
24,5/16/2020,37968,152207,1500,6755,598,0,0,0,2806,2040,1943,97,982,6367,190175,7349,49,76
24,5/17/2020,38804,156122,1460,6993,562,0,0,0,2816,2090,1989,101,836,3915,194926,4751,50,238
24,5/18/2020,39762,161744,1447,7086,555,0,0,0,2817,2122,2020,102,958,5622,201506,6580,32,93
24,5/19/2020,41546,167112,1421,7199,537,0,0,0,2868,2164,2061,103,1784,5368,208658,7152,42,113
24,5/20/2020,42323,173007,1410,7393,539,0,0,0,2993,2198,2093,105,777,5895,215330,6672,34,194
24,5/21/2020,43531,176702,1374,7485,526,0,0,0,3099,2221,2116,105,1208,3695,220233,4903,23,92
24,5/22/2020,44424,183478,1329,7634,506,0,0,0,3243,2274,2169,105,893,6776,227902,7669,53,149
24,5/23/2020,45495,186832,1320,7825,524,0,0,0,3283,2306,2197,109,1071,3354,232327,4425,32,191
24,5/24/2020,46313,194049,1290,7939,503,0,0,0,3319,2341,2229,112,818,7217,240362,8035,35,114
24,5/25/2020,47152,202425,1279,8092,517,0,0,0,3329,2379,2267,112,839,8376,249577,9215,38,153
24,5/26/2020,47687,206800,1315,8179,520,0,0,0,3334,2417,2302,115,535,4375,254487,4910,38,87
24,5/27/2020,48423,213632,1338,8281,520,0,0,0,3401,2458,2343,115,736,6832,262055,7568,41,102
24,5/28/2020,49709,225149,1334,8392,511,0,0,0,3468,2501,2386,115,1286,11517,274858,12803,43,111
24,5/29/2020,50988,233530,1296,8479,507,0,0,0,3571,2538,2421,117,1279,8381,284518,9660,37,87
24,5/30/2020,52015,241931,1239,8619,492,0,0,0,3649,2562,2444,118,1027,8401,293946,9428,24,140
24,5/31/2020,52778,249103,1183,8738,479,0,0,0,3764,2596,2476,120,763,7172,301881,7935,34,119
24,6/1/2020,53327,255403,1174,8886,479,0,0,0,3782,2625,2505,120,549,6300,308730,6849,29,148
24,6/2/2020,54175,261640,1148,8957,481,0,0,0,3855,2646,2525,121,848,6237,315815,7085,21,71
24,6/3/2020,54982,272643,1109,9111,471,0,0,0,3970,2666,2544,122,807,11003,327625,11810,20,154
24,6/4/2020,55858,281160,1096,9217,456,0,0,0,3985,2668,2546,122,876,8517,337018,9393,2,106
24,6/5/2020,56770,290956,1076,9346,455,0,0,0,4159,2702,2580,122,912,9796,347726,10708,34,129
24,6/6/2020,57482,299894,1059,9451,418,0,0,0,4175,2740,2616,124,712,8938,357376,9650,38,105
24,6/7/2020,57973,306830,1003,9546,404,0,0,0,4240,2749,2625,124,491,6936,364803,7427,9,95
24,6/8/2020,58404,313099,979,9629,392,0,0,0,4240,2776,2653,123,431,6269,371503,6700,27,83
24,6/9/2020,58904,319178,970,9676,386,0,0,0,4279,2811,2686,125,500,6079,378082,6579,35,47
24,6/10/2020,59465,325177,955,9755,379,0,0,0,4310,2844,2719,125,561,5999,384642,6560,33,79
24,6/11/2020,60197,332173,902,9789,358,0,0,0,4365,2875,2750,125,732,6996,392370,7728,31,34
24,6/12/2020,60613,339482,836,9923,331,0,0,0,4474,2900,2773,127,416,7309,400095,7725,25,134
24,6/13/2020,61305,347453,799,10053,321,0,0,0,4536,2926,2799,127,692,7971,408758,8663,26,130
24,6/14/2020,61701,353608,751,10165,313,0,0,0,4541,2939,2811,128,396,6155,415309,6551,13,112
24,6/15/2020,62032,359076,745,10222,292,0,0,0,4567,2947,2817,130,331,5468,421108,5799,8,57
24,6/16/2020,62409,366816,742,10262,284,0,0,0,4579,2982,2851,131,377,7740,429225,8117,35,40
24,6/17/2020,62969,378374,702,10309,283,0,0,0,4596,2996,2866,130,560,11558,441343,12118,14,47
24,6/18/2020,63229,384379,660,10357,269,0,0,0,4640,3016,2886,130,260,6005,447608,6265,20,48
24,6/19/2020,63548,390121,648,10447,261,0,0,0,4685,3030,2901,129,319,5742,453669,6061,14,90
24,6/20/2020,63956,398324,644,10497,238,0,0,0,4745,3052,2923,129,408,8203,462280,8611,22,50
24,6/21/2020,64306,404725,608,10544,230,0,0,0,4773,3066,2937,129,350,6401,469031,6751,14,47
24,6/22/2020,64603,410122,602,10572,232,0,0,0,4776,3074,2945,129,297,5397,474725,5694,8,28
24,6/23/2020,65007,418528,561,10611,212,0,0,0,4797,3092,2963,129,404,8406,483535,8810,18,39
24,6/24/2020,65337,425120,544,10648,213,0,0,0,4810,3108,2978,130,330,6592,490457,6922,16,37
24,6/25/2020,65777,433182,511,10683,209,0,0,0,4874,3129,3001,128,440,8062,498959,8502,21,35
24,6/26/2020,66115,440282,487,10725,190,0,0,0,4903,3142,3015,127,338,7100,506397,7438,13,42
24,6/27/2020,66450,447366,478,10751,181,0,0,0,4935,3157,3030,127,335,7084,513816,7419,15,26
24,6/28/2020,66777,452696,446,10793,158,0,0,0,4976,3168,3042,126,327,5330,519473,5657,11,42
24,6/29/2020,67254,462059,447,10822,160,0,0,0,4979,3175,3048,127,477,9363,529313,9840,7,29
24,6/30/2020,67559,468296,452,10844,152,0,0,0,4982,3190,3062,128,305,6237,535855,6542,15,22
24,7/1/2020,67918,474686,461,10902,154,0,0,0,5001,3205,3077,128,359,6390,542604,6749,15,58
24,7/2/2020,68423,484752,441,10939,149,0,0,0,5013,3212,3086,126,505,10066,553175,10571,7,37
24,7/3/2020,68961,494873,422,10973,143,0,0,0,5023,3223,3099,124,538,10121,563834,10659,11,34
24,7/4/2020,69341,504001,410,11034,143,0,0,0,5025,3236,3111,125,380,9128,573342,9508,13,61
24,7/5/2020,69632,510330,409,11071,144,0,0,0,5029,3243,3118,125,291,6329,579962,6620,7,37
24,7/6/2020,69904,517457,403,11096,142,0,0,0,5029,3246,3121,125,272,7127,587361,7399,3,25
24,7/7/2020,70396,523982,404,11111,145,0,0,0,5036,3266,3140,126,492,6525,594378,7017,20,15
24,7/8/2020,70861,532247,398,11184,136,0,0,0,5085,3275,3149,126,465,8265,603108,8730,9,73
24,7/9/2020,71447,541134,406,11221,139,0,0,0,5132,3288,3160,128,586,8887,612581,9473,13,37
24,7/10/2020,71910,549153,385,11300,122,0,0,0,5157,3303,3172,131,463,8019,621063,8482,15,79
24,7/11/2020,72467,556810,390,11353,120,0,0,0,5190,3310,3179,131,557,7657,629277,8214,7,53
24,7/12/2020,73109,570282,392,11420,114,0,0,0,5230,3319,3188,131,642,13472,643391,14114,9,67
24,7/13/2020,73527,578430,386,11467,108,0,0,0,5230,3325,3194,131,418,8148,651957,8566,6,47
24,7/14/2020,74260,591809,415,11485,118,0,0,0,5238,3334,3202,132,733,13379,666069,14112,9,18
24,7/15/2020,75016,605072,447,11625,129,0,0,0,5238,3341,3209,132,756,13263,680088,14019,7,140
24,7/16/2020,75664,616865,436,11687,137,0,0,0,5286,3347,3215,132,648,11793,692529,12441,6,62
24,7/17/2020,76371,631845,434,11728,128,0,0,0,5286,3359,3227,132,707,14980,708216,15687,12,41
25,3/12/2020,8,0,0,0,0,0,0,0,0,0,0,0,0,0,8,0,0,0
25,3/13/2020,23,0,0,0,0,0,0,0,0,0,0,0,15,0,23,15,0,0
25,3/14/2020,38,0,0,0,0,0,0,0,0,0,0,0,15,0,38,15,0,0
25,3/15/2020,64,584,0,0,0,0,0,0,0,0,0,0,26,584,648,610,0,0
25,3/16/2020,97,1199,0,0,0,0,0,0,0,0,0,0,33,615,1296,648,0,0
25,3/17/2020,118,1633,0,0,0,0,0,0,0,0,0,0,21,434,1751,455,0,0
25,3/18/2020,156,2115,0,0,0,0,0,0,0,2,0,0,38,482,2271,520,2,0
25,3/19/2020,229,2918,0,0,0,0,0,0,0,3,0,0,73,803,3147,876,1,0
25,3/20/2020,314,3795,0,0,0,0,0,0,0,5,0,0,85,877,4109,962,2,0
25,3/21/2020,426,4799,0,61,0,0,0,0,0,7,0,0,112,1004,5225,1116,2,61
25,3/22/2020,547,5476,0,71,0,0,0,0,0,11,0,0,121,677,6023,798,4,10
25,3/23/2020,678,8263,0,79,0,0,0,0,0,17,0,0,131,2787,8941,2918,6,8
25,3/24/2020,1060,12714,0,94,0,0,0,0,0,26,0,0,382,4451,13774,4833,9,15
25,3/25/2020,1739,18079,0,103,0,0,0,0,0,33,0,0,679,5365,19818,6044,7,9
25,3/26/2020,2318,21327,0,219,0,0,0,0,0,42,0,0,579,3248,23645,3827,9,116
25,3/27/2020,3151,26244,0,219,0,0,0,0,0,57,0,0,833,4917,29395,5750,15,0
25,3/28/2020,4158,30915,0,350,0,0,0,0,0,72,0,0,1007,4671,35073,5678,15,131
25,3/29/2020,4856,34234,0,399,0,0,0,0,0,99,0,0,698,3319,39090,4017,27,49
25,3/30/2020,5653,37166,0,453,0,0,0,0,0,124,0,0,797,2932,42819,3729,25,54
25,3/31/2020,6521,40440,0,562,0,0,0,0,0,153,0,0,868,3274,46961,4142,29,109
25,4/1/2020,7639,44125,0,682,0,0,0,0,0,187,0,0,1118,3685,51764,4803,34,120
25,4/2/2020,8867,47767,0,813,0,0,0,0,0,229,0,0,1228,3642,56634,4870,42,131
25,4/3/2020,10303,52685,0,966,0,0,0,0,0,265,0,0,1436,4918,62988,6354,36,153
25,4/4/2020,11637,57191,1370,1370,0,0,0,0,0,304,0,0,1334,4506,68828,5840,39,404
25,4/5/2020,12402,59565,1632,1632,0,0,0,0,0,370,0,0,765,2374,71967,3139,66,262
25,4/6/2020,13739,62720,1667,1667,0,0,0,0,0,448,0,0,1337,3155,76459,4492,78,35
25,4/7/2020,15104,66270,1831,1831,0,0,0,0,0,515,0,0,1365,3550,81374,4915,67,164
25,4/8/2020,16692,70849,2119,2119,0,0,0,0,0,615,0,0,1588,4579,87541,6167,100,288
25,4/9/2020,18843,76146,2302,2302,0,0,0,0,0,725,0,0,2151,5297,94989,7448,110,183
25,4/10/2020,20878,81564,2435,2435,0,0,0,0,0,832,0,0,2035,5418,102442,7453,107,133
25,4/11/2020,22766,86115,2507,2507,0,0,0,0,0,946,0,0,1888,4551,108881,6439,114,72
25,4/12/2020,25381,91463,2514,2514,0,0,0,0,0,1056,0,0,2615,5348,116844,7963,110,7
25,4/13/2020,26794,95500,3485,3485,0,0,0,0,0,1211,0,0,1413,4037,122294,5450,155,971
25,4/14/2020,28109,98820,3616,3616,0,0,0,0,0,1329,0,0,1315,3320,126929,4635,118,131
25,4/15/2020,29970,102790,3637,3637,973,0,0,0,0,1502,0,0,1861,3970,132760,5831,173,21
25,4/16/2020,32492,110098,3726,3726,973,0,0,0,0,1667,0,0,2522,7308,142590,9830,165,89
25,4/17/2020,35125,117195,3756,3756,987,0,0,0,0,1822,0,0,2633,7097,152320,9730,155,30
25,4/18/2020,37527,124604,3728,3728,987,0,0,0,0,1983,0,0,2402,7409,162131,9811,161,-28
25,4/19/2020,39820,129295,3789,3789,987,0,0,0,0,2146,0,0,2293,4691,169115,6984,163,61
25,4/20/2020,41416,136046,3872,3872,987,0,0,0,0,2303,0,0,1596,6751,177462,8347,157,83
25,4/21/2020,43168,141444,3977,4009,1040,0,0,0,0,2449,0,0,1752,5398,184612,7150,146,137
25,4/22/2020,44913,144789,3890,4256,1050,0,0,0,0,2597,0,0,1745,3345,189702,5090,148,247
25,4/23/2020,47992,156324,3851,4493,1034,0,0,0,0,2769,0,0,3079,11535,204316,14614,172,237
25,4/24/2020,50969,164244,3847,4752,1034,0,0,0,0,2877,0,0,2977,7920,215213,10897,108,259
25,4/25/2020,53348,173497,3879,4965,1058,0,0,0,0,2877,0,0,2379,9253,226845,11632,0,213
25,4/26/2020,54938,181162,3879,5104,1077,0,0,0,0,2899,0,0,1590,7665,236100,9255,22,139
25,4/27/2020,56462,188425,3892,5237,1089,0,0,0,0,3003,0,0,1524,7263,244887,8787,104,133
25,4/28/2020,58302,196198,3875,5515,1005,0,0,0,0,3153,0,0,1840,7773,254500,9613,150,278
25,4/29/2020,60265,205353,3856,5758,1011,0,0,0,0,3405,0,0,1963,9155,265618,11118,252,243
25,4/30/2020,62205,213442,3803,5942,1001,0,0,0,0,3562,0,0,1940,8089,275647,10029,157,184
25,5/1/2020,64311,225325,3716,6169,947,0,0,0,0,3716,0,0,2106,11883,289636,13989,154,227
25,5/2/2020,66263,232731,3601,6378,921,0,0,0,0,3846,0,0,1952,7406,298994,9358,130,209
25,5/3/2020,68087,246559,3617,6507,904,0,0,0,0,4004,0,0,1824,13828,314646,15652,158,129
25,5/4/2020,69087,255181,3539,6622,908,0,0,0,0,4090,0,0,1000,8622,324268,9622,86,115
25,5/5/2020,70271,263078,3542,6831,914,0,0,0,0,4212,0,0,1184,7897,333349,9081,122,209
25,5/6/2020,72025,267614,3564,7080,922,0,0,0,0,4420,0,0,1754,4536,339639,6290,208,249
25,5/7/2020,73721,277911,3436,7237,852,0,0,0,0,4552,0,0,1696,10297,351632,11993,132,157
25,5/8/2020,75333,290690,3349,7434,826,0,0,0,0,4702,0,0,1612,12779,366023,14391,150,197
25,5/9/2020,76743,299794,3229,7551,814,0,0,0,0,4840,0,0,1410,9104,376537,10514,138,117
25,5/10/2020,77793,310596,3128,7617,810,0,0,0,0,4979,0,0,1050,10802,388389,11852,139,66
25,5/11/2020,78462,316266,3102,7732,813,0,0,0,0,5108,0,0,669,5670,394728,6339,129,115
25,5/12/2020,79332,322164,3127,7842,818,0,0,0,0,5141,5141,0,870,5898,401496,6768,33,110
25,5/13/2020,80497,329535,3101,8032,794,0,0,0,0,5315,5315,0,1165,7371,410032,8536,174,190
25,5/14/2020,82182,342179,2859,8207,781,0,0,0,0,5482,5382,0,1685,12644,424361,14329,167,175
25,5/15/2020,83421,352258,2767,8314,749,0,0,0,0,5592,5592,0,1239,10079,435679,11318,110,107
25,5/16/2020,84933,363156,2692,8456,747,0,0,0,0,5705,5705,0,1512,10898,448089,12410,113,142
25,5/17/2020,86010,374816,2597,8539,702,0,0,0,0,5797,5797,0,1077,11660,460826,12737,92,83
25,5/18/2020,87052,382147,2533,8621,674,0,0,0,0,5862,5862,0,1042,7331,469199,8373,65,82
25,5/19/2020,87925,389015,2472,8766,672,0,0,0,0,5938,5938,0,873,6868,476940,7741,76,145
25,5/20/2020,88970,400983,2518,8897,675,0,0,0,0,6066,6066,0,1045,11968,489953,13013,128,131
25,5/21/2020,90084,411402,2396,9040,647,0,0,0,0,6148,6148,0,1114,10419,501486,11533,82,143
25,5/22/2020,90889,420755,2323,9162,628,0,0,0,0,6228,6228,0,805,9353,511644,10158,80,122
25,5/23/2020,91662,429324,2237,9260,610,0,0,0,0,6304,6304,0,773,8569,520986,9342,76,98
25,5/24/2020,92675,439698,2169,9308,558,0,0,0,0,6372,6372,0,1013,10374,532373,11387,68,48
25,5/25/2020,93271,447290,2132,9339,576,0,0,0,0,6416,6416,0,596,7592,540561,8188,44,31
25,5/26/2020,93693,451788,2108,9388,560,0,0,0,0,6473,6473,0,422,4498,545481,4920,57,49
25,5/27/2020,94220,457924,2106,9492,556,0,0,0,0,6547,6473,0,527,6136,552144,6663,74,104
25,5/28/2020,94895,467428,2112,9618,529,0,0,0,78108,6640,6640,0,675,9504,562323,10179,93,126
25,5/29/2020,95512,476233,1991,9725,485,0,0,0,78108,6718,6718,0,617,8805,571745,9422,78,107
25,5/30/2020,96301,486218,1904,9789,453,0,0,0,78108,6768,6768,0,789,9985,582519,10774,50,64
25,5/31/2020,96965,495888,1824,9823,436,0,0,0,78108,6846,6846,0,664,9670,592853,10334,78,34
25,6/1/2020,100805,502628,1747,9952,404,0,289,0,78108,7035,6894,141,3840,6740,603433,10580,189,129
25,6/2/2020,101163,508232,1657,10063,394,0,269,0,78108,7085,6944,141,358,5604,609395,5962,50,111
25,6/3/2020,101592,516169,1684,10151,393,0,263,0,78108,7152,7012,140,429,7937,617761,8366,67,88
25,6/4/2020,102063,522872,1637,10238,401,0,249,0,84621,7201,7062,139,471,6703,624935,7174,49,87
25,6/5/2020,102557,532212,1533,10303,350,0,238,0,84621,7235,7097,138,494,9340,634769,9834,34,65
25,6/6/2020,103132,541507,1529,10369,359,0,238,0,84621,7289,7152,137,575,9295,644639,9870,54,66
25,6/7/2020,103436,549054,1442,10393,335,0,221,0,84621,7316,7179,137,304,7547,652490,7851,27,24
25,6/8/2020,103626,553643,1415,10425,322,0,209,0,84621,7353,7217,136,190,4589,657269,4779,37,32
25,6/9/2020,103889,558103,1397,10507,315,0,202,0,84621,7408,7255,153,263,4460,661992,4723,55,82
25,6/10/2020,104156,567934,1345,10582,319,0,200,0,84621,7454,7300,154,267,9831,672090,10098,46,75
25,6/11/2020,104667,578421,1260,10654,296,0,181,0,88725,7492,7337,155,511,10487,683088,10998,38,72
25,6/12/2020,105059,588300,1143,10726,276,0,170,0,88725,7538,7382,156,392,9879,693359,10271,46,72
25,6/13/2020,105395,598201,1069,10772,249,0,162,0,88725,7576,7420,156,336,9901,703596,10237,38,46
25,6/14/2020,105603,607107,1039,10802,244,0,156,0,88725,7624,7467,157,208,8906,712710,9114,48,30
25,6/15/2020,105690,611541,1026,10817,253,0,167,0,88725,7647,7490,157,87,4434,717231,4521,23,15
25,6/16/2020,105885,617762,1045,10867,244,0,151,0,88725,7665,7508,157,195,6221,723647,6416,18,50
25,6/17/2020,106151,625895,998,10925,227,0,135,0,88725,7734,7568,166,266,8133,732046,8399,69,58
25,6/18/2020,106422,634838,968,10985,227,0,125,0,91404,7770,7591,179,271,8943,741260,9214,36,60
25,6/19/2020,106650,644157,994,11036,199,0,124,0,91404,7800,7619,181,228,9319,750807,9547,30,51
25,6/20/2020,106936,658001,964,11076,200,0,118,0,91404,7828,7647,181,286,13844,764937,14130,28,40
25,6/21/2020,107061,666259,927,11085,194,0,111,0,91404,7858,7677,181,125,8258,773320,8383,30,9
25,6/22/2020,107210,672853,920,11094,180,0,107,0,91404,7874,7694,180,149,6594,780063,6743,16,9
25,6/23/2020,107439,680203,953,11157,181,0,112,0,91404,7890,7710,180,229,7350,787642,7579,16,63
25,6/24/2020,107611,687461,939,11219,181,0,98,0,91404,7938,7752,186,172,7258,795072,7430,48,62
25,6/25/2020,107837,697619,822,11252,174,0,101,0,93157,7963,7776,187,226,10158,805456,10384,25,33
25,6/26/2020,108070,706015,791,11291,156,0,99,0,93157,8013,7815,198,233,8396,814085,8629,50,39
25,6/27/2020,108443,717899,769,11310,143,0,90,0,93157,8041,7841,200,373,11884,826342,12257,28,19
25,6/28/2020,108667,727127,748,11319,134,0,81,0,93157,8060,7860,200,224,9228,835794,9452,19,9
25,6/29/2020,108768,733519,762,11345,138,0,79,0,93157,8095,7895,200,101,6392,842287,6493,35,26
25,6/30/2020,108882,739259,733,11337,120,0,63,0,93157,8054,7874,180,114,5740,848141,5854,-41,-8
25,7/1/2020,109143,749292,760,11352,123,0,65,0,93157,8081,7902,179,261,10033,858435,10294,27,15
25,7/2/2020,109338,756920,681,11392,113,0,52,0,93157,8132,7918,214,195,7628,866258,7823,51,40
25,7/3/2020,109628,768152,656,11436,106,0,55,0,93157,8149,7935,214,290,11232,877780,11522,17,44
25,7/4/2020,109838,775929,640,11461,107,0,51,0,93157,8172,7958,214,210,7777,885767,7987,23,25
25,7/5/2020,109974,781711,636,11463,100,0,46,0,93157,8183,7968,215,136,5782,891685,5918,11,2
25,7/6/2020,110137,789280,603,11469,99,0,51,0,93157,8198,7983,215,163,7569,899417,7732,15,6
25,7/7/2020,110338,796422,621,11489,104,0,50,0,93157,8213,7998,215,201,7142,906760,7343,15,20
25,7/8/2020,110602,805393,662,11517,102,0,49,0,94347,8243,8028,215,264,8971,915995,9235,30,28
25,7/9/2020,110897,814864,635,11559,103,0,42,0,94347,8268,8053,215,295,9471,925761,9766,25,42
25,7/10/2020,111110,827506,632,11582,98,0,47,0,94347,8296,8081,215,213,12642,938616,12855,28,23
25,7/11/2020,111398,834936,572,11600,87,0,44,0,94347,8310,8095,215,288,7430,946334,7718,14,18
25,7/12/2020,111597,845883,583,11608,93,0,43,0,94347,8325,8110,215,199,10947,957480,11146,15,8
25,7/13/2020,111827,854316,570,11611,89,0,46,0,94347,8330,8115,215,230,8433,966143,8663,5,3
25,7/14/2020,112130,866084,560,11625,93,0,37,0,94347,8340,8125,215,303,11768,978214,12071,10,14
25,7/15/2020,112347,876366,580,11651,80,0,40,0,95390,8368,8152,216,217,10282,988713,10499,28,26
25,7/16/2020,112581,889103,557,11663,77,0,38,0,95390,8380,8163,217,234,12737,1001684,12971,12,12
25,7/17/2020,112879,901708,515,11691,76,0,34,0,95390,8402,8184,218,298,12605,1014587,12903,22,28
26,3/1/2020,9,0,0,0,0,0,0,0,0,0,0,0,0,0,9,0,0,0
26,3/2/2020,18,0,0,0,0,0,0,0,0,0,0,0,9,0,18,9,0,0
26,3/3/2020,34,0,0,0,0,0,0,0,0,0,0,0,16,0,34,16,0,0
26,3/4/2020,52,0,0,0,0,0,0,0,0,0,0,0,18,0,52,18,0,0
26,3/5/2020,72,8,0,0,0,0,0,0,0,0,0,0,20,8,80,28,0,0
26,3/6/2020,98,8,0,0,0,0,0,0,0,0,0,0,26,0,106,26,0,0
26,3/7/2020,128,18,0,0,0,0,0,0,0,0,0,0,30,10,146,40,0,0
26,3/8/2020,168,26,0,0,0,0,0,0,0,0,0,0,40,8,194,48,0,0
26,3/9/2020,254,36,0,0,0,0,0,0,0,0,0,0,86,10,290,96,0,0
26,3/10/2020,358,39,0,0,0,0,0,0,0,0,0,0,104,3,397,107,0,0
26,3/11/2020,497,57,0,0,0,0,0,0,0,0,0,0,139,18,554,157,0,0
26,3/12/2020,702,91,0,0,0,0,0,0,0,0,0,1,205,34,793,239,0,0
26,3/13/2020,945,133,0,0,0,0,0,0,0,0,0,1,243,42,1078,285,0,0
26,3/14/2020,1196,205,0,0,0,0,0,0,0,0,0,1,251,72,1401,323,0,0
26,3/15/2020,1480,205,0,0,0,0,0,0,0,0,0,1,284,0,1685,284,0,0
26,3/16/2020,1933,272,0,0,0,0,0,0,0,0,1,1,453,67,2205,520,0,0
26,3/17/2020,3659,879,0,0,0,0,0,0,0,2,4,1,1726,607,4538,2333,2,0
26,3/18/2020,4531,1478,0,0,0,0,0,0,0,5,9,1,872,599,6009,1471,3,0
26,3/19/2020,5276,2051,0,0,0,0,0,0,0,10,11,1,745,573,7327,1318,5,0
26,3/20/2020,6219,3041,0,0,0,0,0,0,0,13,20,2,943,990,9260,1933,3,0
26,3/21/2020,7023,4086,0,0,0,0,0,0,0,23,33,3,804,1045,11109,1849,10,0
26,3/22/2020,7822,4791,0,0,0,0,0,0,0,36,54,3,799,705,12613,1504,13,0
26,3/23/2020,9062,5847,0,0,0,0,0,0,0,57,79,3,1240,1056,14909,2296,21,0
26,3/24/2020,10155,6989,0,0,0,0,0,0,0,86,103,7,1093,1142,17144,2235,29,0
26,3/25/2020,11335,8842,0,0,0,0,0,0,0,111,149,8,1180,1853,20177,3033,25,0
26,3/26/2020,12475,11730,0,0,0,0,0,0,0,159,197,10,1140,2888,24205,4028,48,0
26,3/27/2020,13799,14140,0,0,0,0,0,0,0,212,264,15,1324,2410,27939,3734,53,0
26,3/28/2020,14865,15902,0,0,0,0,0,0,0,283,326,19,1066,1762,30767,2828,71,0
26,3/29/2020,15784,17417,0,0,0,0,0,0,0,351,408,25,919,1515,33201,2434,68,0
26,3/30/2020,17363,23263,0,0,0,0,0,0,0,437,518,29,1579,5846,40626,7425,86,0
26,3/31/2020,18654,26334,0,0,0,0,0,0,0,551,641,33,1291,3071,44988,4362,114,0
26,4/1/2020,20246,29951,0,0,0,0,0,0,0,676,765,35,1592,3617,50197,5209,125,0
26,4/2/2020,21376,33443,0,0,0,0,0,0,0,801,879,36,1130,3492,54819,4622,125,0
26,4/3/2020,22579,37060,0,0,0,0,0,0,56,918,985,39,1203,3617,59639,4820,117,0
26,4/4/2020,23581,41205,0,0,0,0,0,0,56,1030,1092,45,1002,4145,64786,5147,112,0
26,4/5/2020,24458,44154,0,0,0,0,0,0,56,1150,1225,58,877,2949,68612,3826,120,0
26,4/6/2020,25785,47262,0,0,0,0,0,0,56,1291,1377,66,1327,3108,73047,4435,141,0
26,4/7/2020,26964,50344,0,0,0,0,0,0,56,1449,1522,72,1179,3082,77308,4261,158,0
26,4/8/2020,28064,53176,0,0,0,0,0,0,56,1600,1668,78,1100,2832,81240,3932,151,0
26,4/9/2020,29096,56430,3826,0,1628,0,1434,0,56,1756,1822,88,1032,3254,85526,4286,156,0
26,4/10/2020,30172,59597,3823,0,1663,0,1394,0,56,1917,1978,95,1076,3167,89769,4243,161,0
26,4/11/2020,30980,62241,3636,0,1582,0,1441,0,595,2081,2136,103,808,2644,93221,3452,164,0
26,4/12/2020,31666,64555,3636,0,1582,0,1441,0,433,2249,2269,113,686,2314,96221,3000,168,0
26,4/13/2020,32702,67063,3986,0,1570,0,1365,0,447,2391,2401,122,1036,2508,99765,3544,142,0
26,4/14/2020,33613,70675,3910,0,1497,0,1235,0,452,2532,2537,131,911,3612,104288,4523,141,0
26,4/15/2020,34533,73828,3918,0,1468,0,1212,0,452,2672,2701,135,920,3153,108361,4073,140,0
26,4/16/2020,35455,78274,3809,0,1447,0,1211,0,617,2841,2836,140,922,4446,113729,5368,169,0
26,4/17/2020,36320,83268,3674,0,1428,0,1167,0,629,2984,2955,148,865,4994,119588,5859,143,0
26,4/18/2020,37029,87114,3634,0,1423,0,1203,0,3237,3107,3076,152,709,3846,124143,4555,123,0
26,4/19/2020,37557,89758,3403,0,1344,0,1115,0,3237,3236,3178,160,528,2644,127315,3172,129,0
26,4/20/2020,38494,93393,3374,0,1346,0,1102,0,3237,3347,3300,169,937,3635,131887,4572,111,0
26,4/21/2020,39589,99667,3357,0,1346,0,1107,0,3237,3471,3428,171,1095,6274,139256,7369,124,0
26,4/22/2020,40705,106653,3305,0,1350,0,1065,0,3237,3602,3531,174,1116,6986,147358,8102,131,0
26,4/23/2020,41694,115005,3611,0,1148,0,1027,0,3237,3711,3636,180,989,8352,156699,9341,109,0
26,4/24/2020,42730,123054,3022,0,1176,0,965,0,3237,3818,3745,182,1036,8049,165784,9085,107,0
26,4/25/2020,43263,128955,2889,0,1164,0,934,0,8342,3929,3846,184,533,5901,172218,6434,111,0
26,4/26/2020,43789,134431,2757,0,1099,0,871,0,8342,4036,3957,190,526,5476,178220,6002,107,0
26,4/27/2020,44709,140972,2667,0,1059,0,832,0,8342,4148,4049,191,920,6541,185681,7461,112,0
26,4/28/2020,45538,148910,2623,0,1027,0,801,0,8342,4247,4136,198,829,7938,194448,8767,99,0
26,4/29/2020,46488,158373,2498,0,997,0,778,0,8342,4335,4232,199,950,9463,204861,10413,88,0
26,4/30/2020,47505,168944,2319,0,966,0,760,0,8342,4434,4317,202,1017,10571,216449,11588,99,0
26,5/1/2020,48240,178807,2319,0,966,0,760,0,8342,4520,4376,203,735,9863,227047,10598,86,0
26,5/2/2020,48672,188713,2100,0,850,0,713,0,15659,4579,4436,203,432,9906,237385,10338,59,0
26,5/3/2020,49029,195361,2100,0,850,0,713,0,15659,4641,4516,205,357,6648,244390,7005,62,0
26,5/4/2020,49809,202671,1948,0,839,0,670,0,15659,4722,4573,206,780,7310,252480,8090,81,0
26,5/5/2020,50497,213091,1948,0,839,0,670,0,15659,4781,4630,208,688,10420,263588,11108,59,0
26,5/6/2020,51131,224563,1818,0,794,0,617,0,15659,4839,4714,209,634,11472,275694,12106,58,0
26,5/7/2020,51731,236184,1697,0,753,0,612,0,15659,4925,4772,211,600,11621,287915,12221,86,0
26,5/8/2020,52349,248142,1637,0,725,0,570,0,15659,4987,4809,215,618,11958,300491,12576,62,0
26,5/9/2020,52732,259265,1531,0,683,0,539,0,22686,5036,4853,227,383,11123,311997,11506,49,0
26,5/10/2020,53033,267417,1437,0,674,0,536,0,22686,5081,4911,228,301,8152,320450,8453,45,0
26,5/11/2020,54004,278293,1424,0,685,0,557,0,22686,5139,4958,228,971,10876,332297,11847,58,0
26,5/12/2020,55641,291701,1384,0,693,0,525,0,22686,5188,5001,230,1637,13408,347342,15045,49,0
26,5/13/2020,56458,310242,1384,0,693,0,525,0,22686,5232,5046,231,817,18541,366700,19358,44,0
26,5/14/2020,57036,326657,1330,0,653,0,515,0,22686,5278,5092,232,578,16415,383693,16993,46,0
26,5/15/2020,57687,341827,1256,0,532,0,440,0,22686,5325,5124,233,651,15170,399514,15821,47,0
26,5/16/2020,58023,353156,1256,0,532,0,440,0,28234,5357,5163,233,336,11329,411179,11665,32,0
26,5/17/2020,58278,363548,1114,0,488,0,434,0,28234,5396,5194,233,255,10392,421826,10647,39,0
26,5/18/2020,58812,376115,1075,0,473,0,418,0,28234,5427,5237,233,534,12567,434927,13101,31,0
26,5/19/2020,59576,392208,1079,0,486,0,351,0,28234,5470,5278,233,764,16093,451784,16857,43,0
26,5/20/2020,60151,405848,1066,0,492,0,332,0,28234,5514,5318,236,575,13640,465999,14215,44,0
26,5/21/2020,60610,421788,1054,0,472,0,361,0,28234,5555,5349,237,459,15940,482398,16399,41,0
26,5/22/2020,61075,441282,955,0,470,0,348,0,28234,5586,5375,237,465,19494,502357,19959,31,0
26,5/23/2020,61293,455556,953,0,449,0,319,0,33168,5612,5402,237,218,14274,516849,14492,26,0
26,5/24/2020,61457,467087,953,0,449,0,319,0,33168,5640,5440,238,164,11531,528544,11695,28,0
26,5/25/2020,61632,476325,953,0,449,0,319,0,33168,5678,5463,238,175,9238,537957,9413,38,0
26,5/26/2020,62075,487906,953,0,449,0,319,0,33168,5703,5487,240,443,11581,549981,12024,25,0
26,5/27/2020,62461,505609,882,0,388,0,272,0,33168,5727,5511,240,386,17703,568070,18089,24,0
26,5/28/2020,62797,522663,860,0,405,0,251,0,33168,5751,5538,240,336,17054,585460,17390,24,0
26,5/29/2020,63116,538868,774,0,371,0,250,0,33168,5778,5562,240,319,16205,601984,16524,27,0
26,5/30/2020,63321,554509,774,0,371,0,250,0,38099,5802,5578,240,205,15641,617830,15846,24,0
26,5/31/2020,63568,567192,774,0,371,0,250,0,38099,5818,5601,240,247,12683,630760,12930,16,0
26,6/1/2020,63813,581424,674,0,346,0,240,0,38099,5843,5627,242,245,14232,645237,14477,25,0
26,6/2/2020,64103,597072,674,0,346,0,240,0,38099,5869,5641,242,290,15648,661175,15938,26,0
26,6/3/2020,64382,613173,646,0,328,0,224,0,38099,5884,5657,243,279,16101,677555,16380,15,0
26,6/4/2020,64616,627907,617,0,321,0,205,0,38099,5901,5665,244,234,14734,692523,14968,17,0
26,6/5/2020,64821,640450,617,0,321,0,205,0,38099,5909,5672,244,205,12543,705271,12748,8,0
26,6/6/2020,64914,650942,864,0,315,0,191,0,42041,5916,5683,244,93,10492,715856,10585,7,0
26,6/7/2020,64969,661256,864,0,315,0,191,0,42041,5927,5698,244,55,10314,726225,10369,11,0
26,6/8/2020,65104,674060,661,0,249,0,191,0,42041,5942,5707,244,135,12804,739164,12939,15,0
26,6/9/2020,65167,690869,661,0,249,0,150,0,42041,5951,5708,244,63,16809,756036,16872,9,0
26,6/10/2020,65182,690869,661,0,249,0,150,0,42041,5952,5708,244,15,0,756051,15,1,0
26,6/11/2020,65449,705071,661,0,249,0,150,0,42041,5985,5738,247,267,14202,770520,14469,33,0
26,6/12/2020,65672,720615,636,0,253,0,139,0,42041,5990,5745,245,223,15544,786287,15767,5,0
26,6/13/2020,65836,733647,636,0,253,0,139,0,44964,6013,5768,245,164,13032,799483,13196,23,0
26,6/14/2020,66054,747444,636,0,253,0,139,0,44964,6016,5771,245,218,13797,813498,14015,3,0
26,6/15/2020,66085,757952,562,0,210,0,139,0,44964,6017,5772,245,31,10508,824037,10539,1,0
26,6/16/2020,66269,769265,562,0,210,0,131,0,44964,6034,5790,244,184,11313,835534,11497,17,0
26,6/17/2020,66497,783388,562,0,210,0,131,0,44964,6036,5792,244,228,14123,849885,14351,2,0
26,6/18/2020,66798,783388,557,0,209,0,101,0,44964,6061,5818,243,301,0,850186,301,25,0
26,6/19/2020,67097,812831,557,0,209,0,99,0,44964,6067,5823,244,299,29443,879928,29742,6,0
26,6/20/2020,67545,827089,557,0,209,0,99,0,49290,6087,5843,244,448,14258,894634,14706,20,0
26,6/21/2020,67711,839715,324,0,181,0,99,0,49290,6090,5846,244,166,12626,907426,12792,3,0
26,6/22/2020,67957,850060,557,0,209,0,99,0,49290,6097,5853,244,246,10345,918017,10591,7,0
26,6/23/2020,68197,860471,557,0,209,0,99,0,49290,6109,5864,245,240,10411,928668,10651,12,0
26,6/24/2020,68555,876250,557,0,209,0,124,0,49290,6114,5868,246,358,15779,944805,16137,5,0
26,6/25/2020,68989,893850,557,0,193,0,115,0,49290,6133,5886,247,434,17600,962839,18034,19,0
26,6/26/2020,69329,912377,557,0,193,0,106,0,49290,6134,5888,246,340,18527,981706,18867,1,0
26,6/27/2020,69679,931142,557,0,193,0,106,0,51099,6153,5907,246,350,18765,1000821,19115,19,0
26,6/28/2020,69946,946733,557,0,193,0,106,0,51099,6158,5912,246,267,15591,1016679,15858,5,0
26,6/29/2020,70223,959152,557,0,193,0,106,0,51099,6161,5915,246,277,12419,1029375,12696,3,0
26,6/30/2020,70728,974329,471,0,179,0,98,0,51099,6193,5947,246,505,15177,1045057,15682,32,0
26,7/1/2020,71089,990770,471,0,179,0,103,0,51099,6198,5951,247,361,16441,1061859,16802,5,0
26,7/2/2020,71678,1013459,548,0,193,0,103,0,51099,6212,5966,246,589,22689,1085137,23278,14,0
26,7/3/2020,72175,1036090,548,0,193,0,92,0,51099,6215,5969,246,497,22631,1108265,23128,3,0
26,7/4/2020,72581,1057573,548,0,193,0,92,0,52841,6218,5972,246,406,21483,1130154,21889,3,0
26,7/5/2020,72941,1073878,548,0,193,0,92,0,52841,6218,5972,246,360,16305,1146819,16665,0,0
26,7/6/2020,73269,1086094,505,0,174,0,92,0,52841,6221,5975,246,328,12216,1159363,12544,3,0
26,7/7/2020,73900,1102611,505,0,174,0,99,0,52841,6251,6005,246,631,16517,1176511,17148,30,0
26,7/8/2020,74551,1125452,505,0,174,0,93,0,52841,6262,6015,247,651,22841,1200003,23492,11,0
26,7/9/2020,75063,1148490,505,0,174,0,93,0,52841,6271,6024,247,512,23038,1223553,23550,9,0
26,7/10/2020,75685,1171120,505,0,174,0,92,0,52841,6285,6039,246,622,22630,1246805,23252,14,0
26,7/11/2020,76370,1197752,505,0,174,0,99,0,53867,6313,6067,246,685,26632,1274122,27317,28,0
26,7/12/2020,76776,1219379,505,0,174,0,99,0,53867,6314,6068,246,406,21627,1296155,22033,1,0
26,7/13/2020,77198,1236229,543,0,184,0,113,0,53867,6321,6075,246,422,16850,1313427,17272,7,0
26,7/14/2020,77864,1255922,543,0,184,0,109,0,53867,6326,6081,245,666,19693,1333786,20359,5,0
26,7/15/2020,78913,1289006,543,0,184,0,107,0,53867,6330,6085,245,1049,33084,1367919,34133,4,0
26,7/16/2020,79839,1315315,680,0,201,0,107,0,53867,6348,6101,247,926,26309,1395154,27235,18,0
26,7/17/2020,80593,1344913,680,0,201,0,88,0,53867,6355,6108,247,754,29598,1425506,30352,7,0
27,3/6/2020,1,36,0,0,0,0,0,0,0,0,0,0,0,0,37,0,0,0
27,3/7/2020,2,48,0,0,0,0,0,0,0,0,0,0,1,12,50,13,0,0
27,3/8/2020,2,48,0,0,0,0,0,0,0,0,0,0,0,0,50,0,0,0
27,3/9/2020,5,80,0,0,0,0,0,0,0,0,0,0,3,32,85,35,0,0
27,3/10/2020,11,132,0,0,0,0,0,0,0,0,0,0,6,52,143,58,0,0
27,3/11/2020,21,217,0,0,0,0,0,0,0,0,0,0,10,85,238,95,0,0
27,3/12/2020,43,307,0,0,0,0,0,0,0,0,0,0,22,90,350,112,0,0
27,3/13/2020,62,541,0,0,0,0,0,0,0,0,0,0,19,234,603,253,0,0
27,3/14/2020,90,847,0,0,0,0,0,0,0,0,0,0,28,306,937,334,0,0
27,3/15/2020,128,1387,0,0,0,0,0,0,0,0,0,0,38,540,1515,578,0,0
27,3/16/2020,179,1839,0,0,0,0,0,0,0,0,0,0,51,452,2018,503,0,0
27,3/17/2020,246,2276,0,0,0,0,0,0,0,0,0,0,67,437,2522,504,0,0
27,3/18/2020,269,2685,0,0,0,0,0,0,0,0,0,0,23,409,2954,432,0,0
27,3/19/2020,287,2949,0,0,0,0,0,0,0,0,0,0,18,264,3236,282,0,0
27,3/20/2020,303,3741,0,0,0,0,0,0,0,0,0,0,16,792,4044,808,0,0
27,3/21/2020,327,3952,0,0,0,0,0,0,0,1,0,0,24,211,4279,235,1,0
27,3/22/2020,349,4511,0,12,0,0,0,0,0,1,0,0,22,559,4860,581,0,12
27,3/23/2020,393,4511,0,17,0,0,0,0,0,1,0,0,44,0,4904,44,0,5
27,3/24/2020,444,5550,0,21,0,0,0,0,0,1,0,0,51,1039,5994,1090,0,4
27,3/25/2020,502,11188,26,35,0,0,0,0,121,1,0,0,58,5638,11690,5696,0,14
27,3/26/2020,565,12604,31,41,0,0,0,0,0,2,0,0,63,1416,13169,1479,1,6
27,3/27/2020,640,13605,34,51,0,17,0,0,176,4,0,0,75,1001,14245,1076,2,10
27,3/28/2020,687,17395,30,57,0,17,0,0,215,5,0,0,47,3790,18082,3837,1,6
27,3/29/2020,725,18566,39,75,0,17,0,0,243,9,0,0,38,1171,19291,1209,4,18
27,3/30/2020,823,19512,56,92,24,24,0,0,0,10,0,0,98,946,20335,1044,1,17
27,3/31/2020,916,20935,56,112,26,26,0,0,0,12,0,0,93,1423,21851,1516,2,20
27,4/1/2020,973,21880,54,122,27,27,0,0,0,17,0,0,57,945,22853,1002,5,10
27,4/2/2020,1056,23780,75,138,38,38,0,0,0,18,0,0,83,1900,24836,1983,1,16
27,4/3/2020,1119,25063,86,156,40,40,0,0,0,22,0,0,63,1283,26182,1346,4,18
27,4/4/2020,1158,26687,95,180,42,69,0,0,416,24,0,0,39,1624,27845,1663,2,24
27,4/5/2020,1217,28090,106,202,48,77,0,0,422,29,0,0,59,1403,29307,1462,5,22
27,4/6/2020,1330,29155,115,223,57,90,0,0,440,30,0,0,113,1065,30485,1178,1,21
27,4/7/2020,1432,30603,120,242,64,100,0,0,515,34,0,0,102,1448,32035,1550,4,19
27,4/8/2020,1534,31954,135,271,64,105,0,0,593,39,0,0,102,1351,33488,1453,5,29
27,4/9/2020,1637,33682,145,293,63,119,0,0,625,50,0,0,103,1728,35319,1831,11,22
27,4/10/2020,1732,35346,143,317,64,131,0,0,675,57,0,0,95,1664,37078,1759,7,24
27,4/11/2020,1806,36898,145,340,69,138,0,0,729,64,0,0,74,1552,38704,1626,7,23
27,4/12/2020,1864,38030,157,361,74,146,0,0,772,70,0,0,58,1132,39894,1190,6,21
27,4/13/2020,2012,38667,157,361,74,146,0,0,772,70,0,0,148,637,40679,785,0,0
27,4/14/2020,2165,39705,177,405,75,155,0,0,830,79,0,0,153,1038,41870,1191,9,44
27,4/15/2020,2321,41245,197,445,93,175,0,0,853,87,0,0,156,1540,43566,1696,8,40
27,4/16/2020,2486,42536,213,475,103,188,0,0,926,94,0,0,165,1291,45022,1456,7,30
27,4/17/2020,2668,43820,223,518,106,202,0,0,955,111,0,0,182,1284,46488,1466,17,43
27,4/18/2020,2788,45182,239,561,111,215,0,0,997,121,0,0,120,1362,47970,1482,10,43
27,4/19/2020,2914,46288,228,574,116,226,0,0,1026,134,0,0,126,1106,49202,1232,13,13
27,4/20/2020,3190,46854,237,602,126,241,0,0,1059,143,0,0,276,566,50044,842,9,28
27,4/21/2020,3452,48341,237,629,117,253,0,0,1094,160,0,0,262,1487,51793,1749,17,27
27,4/22/2020,3758,50165,240,660,107,262,0,0,1138,179,0,0,306,1824,53923,2130,19,31
27,4/23/2020,4270,52144,268,712,104,274,0,0,1336,200,0,0,512,1979,56414,2491,21,52
27,4/24/2020,4788,54706,278,756,111,281,0,0,1373,221,0,0,518,2562,59494,3080,21,44
27,4/25/2020,5127,56982,288,797,109,291,0,0,1410,244,0,0,339,2276,62109,2615,23,41
27,4/26/2020,5512,59161,285,829,115,301,0,0,1502,272,0,0,385,2179,64673,2564,28,32
27,4/27/2020,6187,60503,292,861,122,316,0,0,1556,286,0,0,675,1342,66690,2017,14,32
27,4/28/2020,6788,63248,314,912,120,324,0,0,1611,301,0,0,601,2745,70036,3346,15,51
27,4/29/2020,7468,69650,320,950,119,337,0,0,1724,319,0,0,680,6402,77118,7082,18,38
27,4/30/2020,8116,73349,365,1044,130,358,0,0,1829,343,0,0,648,3699,81465,4347,24,94
27,5/1/2020,8736,77214,369,1096,118,380,0,0,1911,371,0,0,620,3865,85950,4485,28,52
27,5/2/2020,9071,80609,389,1159,135,404,0,0,2002,395,0,0,335,3395,89680,3730,24,63
27,5/3/2020,9411,83433,373,1199,155,426,0,0,2596,419,0,0,340,2824,92844,3164,24,40
27,5/4/2020,10235,86677,396,1271,166,444,0,0,3784,428,0,0,824,3244,96912,4068,9,72
27,5/5/2020,10876,89202,434,1350,182,475,0,0,4159,455,0,0,641,2525,100078,3166,27,79
27,5/6/2020,11510,93047,443,1405,180,488,0,0,4520,485,0,0,634,3845,104557,4479,30,55
27,5/7/2020,12328,97244,435,1459,182,512,0,0,4800,508,0,0,818,4197,109572,5015,23,54
27,5/8/2020,13040,101408,473,1549,198,540,0,0,5163,534,0,0,712,4164,114448,4876,26,90
27,5/9/2020,13321,106040,476,1612,180,556,0,0,5764,558,0,0,281,4632,119361,4913,24,63
27,5/10/2020,13552,111109,434,1657,199,581,0,0,6304,578,0,0,231,5069,124661,5300,20,45
27,5/11/2020,14379,115585,452,1716,194,600,0,0,6945,591,0,0,827,4476,129964,5303,13,59
27,5/12/2020,15043,118934,496,1799,199,625,0,0,7609,614,614,0,664,3349,133977,4013,23,83
27,5/13/2020,15772,125502,494,1851,199,647,0,0,8149,638,638,9,729,6568,141274,7297,24,52
27,5/14/2020,16565,131443,498,1915,203,663,0,0,8473,663,663,9,793,5941,148008,6734,25,64
27,5/15/2020,17363,139773,498,1985,200,679,0,0,8820,692,683,9,798,8330,157136,9128,29,70
27,5/16/2020,17705,147399,493,2039,225,700,0,0,9571,709,700,9,342,7626,165104,7968,17,54
27,5/17/2020,18016,153069,487,2090,221,716,0,0,10175,731,722,9,311,5670,171085,5981,22,51
27,5/18/2020,18987,158487,488,2128,229,731,0,0,10764,740,731,9,971,5418,177474,6389,9,38
27,5/19/2020,19842,164009,545,2221,229,750,0,0,11540,757,748,9,855,5522,183851,6377,17,93
27,5/20/2020,20609,170199,550,2308,212,773,0,0,12227,786,777,9,767,6190,190808,6957,29,87
27,5/21/2020,21582,177506,566,2380,229,787,0,0,12488,818,809,9,973,7307,199088,8280,32,72
27,5/22/2020,22374,186436,534,2432,233,806,0,0,12696,851,842,9,792,8930,208810,9722,33,52
27,5/23/2020,22765,194941,568,2534,215,832,0,0,13485,861,852,9,391,8505,217706,8896,10,102
27,5/24/2020,23121,201566,553,2588,207,841,0,0,14115,878,869,9,356,6625,224687,6981,17,54
27,5/25/2020,23524,207816,605,2676,248,869,0,0,14816,890,881,9,403,6250,231340,6653,12,88
27,5/26/2020,24308,213974,570,2709,258,886,0,0,15523,908,899,9,784,6158,238282,6942,18,33
27,5/27/2020,24988,222821,598,2796,260,902,0,0,16314,942,932,10,680,8847,247809,9527,34,87
27,5/28/2020,25559,232195,606,2880,242,924,0,0,16655,977,967,10,571,9374,257754,9945,35,84
27,5/29/2020,26013,242124,592,2936,259,938,0,0,16930,1006,996,10,454,9929,268137,10383,29,56
27,5/30/2020,26181,250392,589,3011,263,960,0,0,17864,1036,1026,10,168,8268,276573,8436,30,75
27,5/31/2020,26322,257133,555,3047,257,971,0,0,18695,1050,1040,10,141,6741,283455,6882,14,36
27,6/1/2020,26897,260739,549,3086,253,981,0,0,19441,1060,1050,10,575,3606,287636,4181,10,39
27,6/2/2020,27376,267931,537,3134,248,1003,0,0,20381,1082,1072,10,479,7192,295307,7671,22,48
27,6/3/2020,27889,283319,537,3203,254,1022,0,0,21169,1097,1086,11,513,15388,311208,15901,15,69
27,6/4/2020,28290,293858,512,3253,244,1033,0,0,21490,1126,1115,11,401,10539,322148,10940,29,50
27,6/5/2020,28688,304497,478,3289,220,1044,0,0,21864,1159,1148,11,398,10639,333185,11037,33,36
27,6/6/2020,28853,314744,473,3336,206,1044,0,0,22253,1181,1170,11,165,10247,343597,10412,22,47
27,6/7/2020,28988,324153,450,3367,199,1044,0,0,22992,1197,1186,11,135,9409,353141,9544,16,31
27,6/8/2020,29436,331476,452,3401,198,1052,0,0,23657,1208,1197,11,448,7323,360912,7771,11,34
27,6/9/2020,29866,339927,455,3441,199,1068,0,0,24221,1228,1217,11,430,8451,369793,8881,20,40
27,6/10/2020,30199,351634,427,3482,193,1083,0,0,24675,1267,1236,31,333,11707,381833,12040,39,41
27,6/11/2020,30418,364816,411,3522,196,1091,0,0,24870,1280,1249,31,219,13182,395234,13401,13,40
27,6/12/2020,30463,377589,403,3557,191,1093,0,0,25028,1305,1274,31,45,12773,408052,12818,25,35
27,6/13/2020,30465,387245,390,3581,191,1104,0,0,25620,1314,1283,31,2,9656,417710,9658,9,24
27,6/14/2020,30471,387239,369,3610,186,1110,0,0,26090,1329,1298,31,6,-6,417710,0,15,29
27,6/15/2020,30693,392229,353,3630,186,1121,0,0,26609,1335,1304,31,222,4990,422922,5212,6,20
27,6/16/2020,30882,398263,357,3658,185,1128,0,0,27006,1344,1313,31,189,6034,429145,6223,9,28
27,6/17/2020,31296,417291,351,3689,181,1136,0,0,27404,1357,1325,32,414,19028,448587,19442,13,31
27,6/18/2020,31675,429204,345,3718,171,1144,0,0,27566,1376,1344,32,379,11913,460879,12292,19,29
27,6/19/2020,32031,443121,339,3748,168,1150,0,0,27709,1393,1361,32,356,13917,475152,14273,17,30
27,6/20/2020,32467,459576,324,3767,161,1155,0,0,28205,1404,1372,32,436,16455,492043,16891,11,19
27,6/21/2020,32920,471443,322,3797,160,1163,0,0,28663,1412,1380,32,453,11867,504363,12320,8,30
27,6/22/2020,33227,479910,332,3830,156,1180,0,0,29065,1416,1384,32,307,8467,513137,8774,4,33
27,6/23/2020,33469,486576,339,3860,158,1191,0,0,29399,1425,1393,32,242,6666,520045,6908,9,30
27,6/24/2020,33763,495880,340,3897,160,1203,0,0,29707,1432,1397,35,294,9304,529643,9598,7,37
27,6/25/2020,34123,508573,336,3943,162,1218,0,0,29854,1441,1406,35,360,12693,542696,13053,9,46
27,6/26/2020,34616,522662,335,3966,157,1221,0,0,30008,1446,1411,35,493,14089,557278,14582,5,23
27,6/27/2020,35033,533874,300,3986,155,1233,0,0,30401,1452,1417,35,417,11212,568907,11629,6,20
27,6/28/2020,35549,549868,288,4010,143,1241,0,0,30809,1460,1425,35,516,15994,585417,16510,8,24
27,6/29/2020,35861,557094,278,4031,140,1249,0,0,31225,1470,1435,35,312,7226,592955,7538,10,21
27,6/30/2020,36303,569013,270,4054,136,1258,0,0,31601,1476,1441,35,442,11919,605316,12361,6,23
27,7/1/2020,36716,580391,260,4081,125,1258,0,0,31947,1482,1445,37,413,11378,617107,11791,6,27
27,7/2/2020,37210,593217,274,4112,123,1266,0,0,32163,1495,1458,37,494,12826,630427,13320,13,31
27,7/3/2020,37624,607548,270,4139,132,1277,0,0,32347,1503,1466,37,414,14331,645172,14745,8,27
27,7/4/2020,37624,607548,270,4139,132,1277,0,0,32347,1503,1466,37,0,0,645172,0,0,0
27,7/5/2020,38136,635879,253,4170,132,1287,0,0,33408,1508,1471,37,512,28331,674015,28843,5,31
27,7/6/2020,38569,641124,258,4219,125,1290,0,0,33907,1511,1474,37,433,5245,679693,5678,3,49
27,7/7/2020,39133,646114,267,4252,121,1295,0,0,34377,1514,1477,37,564,4990,685247,5554,3,33
27,7/8/2020,39589,653381,265,4272,122,1302,0,0,34902,1523,1485,38,456,7267,692970,7723,9,20
27,7/9/2020,40163,665277,251,4305,116,1312,0,0,35193,1528,1490,38,574,11896,705440,12470,5,33
27,7/10/2020,40767,685058,227,4329,124,1320,0,0,35442,1533,1495,38,604,19781,725825,20385,5,24
27,7/11/2020,41571,700524,241,4366,121,1325,0,0,36012,1537,1499,38,804,15466,742095,16270,4,37
27,7/12/2020,42281,712771,251,4399,123,1335,0,0,36582,1540,1502,38,710,12247,755052,12957,3,33
27,7/13/2020,42772,726217,247,4424,114,1338,0,0,37199,1542,1504,38,491,13446,768989,13937,2,25
27,7/14/2020,43170,734444,236,4452,107,1348,0,0,37749,1548,1510,38,398,8227,777614,8625,6,28
27,7/15/2020,43742,746755,254,4495,106,1353,0,0,38179,1558,1518,40,572,12311,790497,12883,10,43
27,7/16/2020,44347,760865,249,4526,103,1357,0,0,38290,1566,1526,40,605,14110,805212,14715,8,31
27,7/17/2020,45013,774498,252,4563,110,1369,0,0,38568,1573,1533,40,666,13633,819511,14299,7,37
